//MAP CONVERTED BY dmm2tgm.py THIS HEADER COMMENT PREVENTS RECONVERSION, DO NOT REMOVE
"at" = (
/obj/structure/table/wood/poker,
/obj/structure/noticeboard{
	dir = 4;
	pixel_x = -64;
	pixel_y = -32
	},
/turf/open/floor/carpet,
/area/misc/condo)
"aL" = (
/obj/machinery/light_switch/directional/north{
	pixel_x = 18
	},
/obj/machinery/room_controller/directional/north,
/turf/open/floor/carpet/lone,
/area/misc/condo)
"aW" = (
/obj/effect/spawner/liquids_spawner,
/turf/open/floor/iron/pool/cobble/corner{
	dir = 4
	},
/area/misc/condo)
"cl" = (
/turf/open/floor/iron/freezer,
/area/misc/condo)
"cq" = (
/obj/item/kirbyplants/random,
/turf/open/floor/iron/kitchen,
/area/misc/condo)
"dG" = (
/obj/item/kirbyplants/random,
/obj/effect/turf_decal/siding/wood,
/turf/open/floor/wood/large,
/area/misc/condo)
"dO" = (
/obj/item/clothing/suit/jacket/miljacket,
/obj/item/clothing/mask/bandana/skull/black{
	pixel_y = 7;
	pixel_x = 2
	},
/turf/open/floor/plating,
/area/misc/condo)
"ew" = (
/obj/structure/toilet{
	dir = 8
	},
/obj/machinery/light/small/directional/east,
/turf/open/floor/iron/freezer,
/area/misc/condo)
"eE" = (
/obj/machinery/greenscreen_camera{
	dir = 4;
	is_operational = 0;
	name = "camera";
	desc = "A cam-corder. You dread to imagine what's on the tape labelled 'Ren'."
	},
/turf/open/floor/plating,
/area/misc/condo)
"fM" = (
/obj/machinery/light/warm/directional/west,
/obj/effect/turf_decal/siding/wood{
	dir = 8
	},
/turf/open/floor/wood/tile,
/area/misc/condo)
"fY" = (
/obj/effect/spawner/liquids_spawner,
/turf/open/floor/iron/pool/cobble/corner,
/area/misc/condo)
"iW" = (
/obj/machinery/door/morgue,
/turf/open/floor/iron/freezer,
/area/misc/condo)
"jt" = (
/obj/structure/mirror/directional/north,
/obj/effect/turf_decal/siding/wood{
	dir = 1
	},
/turf/open/floor/wood/large,
/area/misc/condo)
"ju" = (
/obj/effect/turf_decal/siding/wood/corner,
/obj/structure/table/wood,
/obj/item/pizzabox/margherita{
	pixel_y = 11
	},
/turf/open/floor/wood/parquet,
/area/misc/condo)
"jz" = (
/obj/structure/railing/corner{
	dir = 1
	},
/obj/effect/spawner/liquids_spawner,
/obj/machinery/light/dim/directional/south,
/turf/open/floor/iron/pool/cobble/corner{
	dir = 8
	},
/area/misc/condo)
"jL" = (
/obj/effect/turf_decal/siding/wood{
	dir = 8
	},
/obj/structure/decorative/shelf,
/obj/machinery/light_switch/directional/west,
/turf/open/floor/wood/tile,
/area/misc/condo)
"kR" = (
/obj/structure/table,
/obj/item/food/vendor_tray_meal/ramen,
/obj/machinery/computer/security/telescreen/entertainment/directional/west,
/turf/open/floor/iron/kitchen,
/area/misc/condo)
"lj" = (
/turf/open/floor/iron/kitchen,
/area/misc/condo)
"lo" = (
/obj/effect/gibspawner/human,
/obj/structure/table/optable,
/obj/machinery/light/red/dim/directional/south,
/turf/open/floor/plating,
/area/misc/condo)
"lw" = (
/obj/structure/table/wood,
/obj/item/flashlight/lamp/green{
	pixel_x = 5;
	pixel_y = 14
	},
/obj/structure/sign/poster/random/directional/east,
/obj/effect/turf_decal/siding/wood{
	dir = 5
	},
/turf/open/floor/wood/parquet,
/area/misc/condo)
"lM" = (
/obj/structure/table/wood/poker,
/obj/item/storage/fancy/donut_box{
	pixel_y = 5
	},
/turf/open/floor/carpet,
/area/misc/condo)
"mc" = (
/obj/structure/table/wood,
/obj/effect/turf_decal/siding/wood{
	dir = 9
	},
/obj/structure/bedsheetbin,
/obj/item/serviette_pack,
/turf/open/floor/wood/parquet,
/area/misc/condo)
"mh" = (
/obj/machinery/computer/security/telescreen/entertainment/directional/north,
/obj/effect/turf_decal/siding/wood{
	dir = 1
	},
/obj/machinery/vending/dorms,
/turf/open/floor/wood/parquet,
/area/misc/condo)
"ml" = (
/obj/structure/table/reinforced,
/obj/machinery/light/cold/directional/east,
/obj/effect/turf_decal/siding/wideplating_new/light{
	dir = 10
	},
/obj/item/kitchen/rollingpin{
	pixel_x = -3
	},
/obj/item/knife/kitchen,
/turf/open/floor/mineral/titanium/tiled/white,
/area/misc/condo)
"mo" = (
/turf/open/floor/wood/tile,
/area/misc/condo)
"mE" = (
/turf/open/floor/carpet/royalblue,
/area/misc/condo)
"nh" = (
/obj/structure/curtain/cloth,
/turf/open/floor/iron/kitchen,
/area/misc/condo)
"nn" = (
/obj/structure/sign/painting/library,
/turf/closed/indestructible/steel,
/area/misc/condo)
"nJ" = (
/obj/machinery/light/warm/directional/north,
/turf/open/floor/carpet/royalblue,
/area/misc/condo)
"nV" = (
/obj/structure/closet/cabinet,
/obj/machinery/light/dim/directional/north,
/obj/effect/turf_decal/siding/wood{
	dir = 1
	},
/turf/open/floor/wood/parquet,
/area/misc/condo)
"ou" = (
/obj/effect/turf_decal/siding/wood{
	dir = 4
	},
/turf/open/floor/wood/tile,
/area/misc/condo)
"pj" = (
/obj/structure/sign/poster/random/directional/south,
/turf/open/floor/iron/kitchen,
/area/misc/condo)
"py" = (
/obj/structure/chair{
	dir = 1
	},
/obj/machinery/light/cold/directional/west,
/turf/open/floor/iron/kitchen,
/area/misc/condo)
"pN" = (
/turf/closed/indestructible/hoteldoor{
	icon_state = "door_closed";
	icon = 'icons/obj/doors/puzzledoor/default.dmi'
	},
/area/misc/condo)
"qD" = (
/obj/structure/table,
/obj/effect/spawner/random/food_or_drink/three_course_meal,
/turf/open/floor/iron/kitchen,
/area/misc/condo)
"qL" = (
/obj/structure/chair,
/obj/structure/extinguisher_cabinet/directional/north,
/turf/open/floor/iron/kitchen,
/area/misc/condo)
"qW" = (
/obj/item/screwdriver/power,
/turf/open/floor/plating,
/area/misc/condo)
"ra" = (
/obj/machinery/light_switch/directional/north,
/obj/structure/curtain,
/obj/machinery/shower/directional/east{
	pixel_x = -10
	},
/obj/item/soap/deluxe,
/turf/open/floor/iron/freezer,
/area/misc/condo)
"sz" = (
/obj/structure/bed/dogbed,
/obj/effect/turf_decal/siding/wood{
	dir = 6
	},
/turf/open/floor/wood/parquet,
/area/misc/condo)
"tX" = (
/obj/structure/sign/poster/random/directional/south,
/obj/structure/table,
/obj/structure/towel_bin,
/turf/open/floor/iron/freezer,
/area/misc/condo)
"ur" = (
/obj/structure/flora/bush/large/style_random,
/obj/structure/flora/bush/lavendergrass/style_random,
/obj/structure/window{
	dir = 8
	},
/obj/structure/window{
	dir = 1
	},
/turf/open/floor/grass,
/area/misc/condo)
"uy" = (
/obj/item/kirbyplants/random,
/obj/effect/turf_decal/siding/wood{
	dir = 9
	},
/turf/open/floor/wood/tile,
/area/misc/condo)
"uz" = (
/obj/item/kirbyplants/random,
/obj/effect/turf_decal/siding/wood/corner,
/obj/effect/turf_decal/siding/wood{
	dir = 10
	},
/turf/open/floor/wood/tile,
/area/misc/condo)
"uB" = (
/obj/machinery/light_switch/directional/south,
/turf/open/floor/carpet/donk,
/area/misc/condo)
"vv" = (
/obj/structure/chair/sofa/corp/left{
	dir = 8
	},
/turf/open/floor/carpet,
/area/misc/condo)
"wr" = (
/obj/structure/closet/secure_closet/wall{
	pixel_y = -32
	},
/obj/effect/turf_decal/tile/neutral/diagonal_edge,
/obj/structure/sink/directional/east,
/obj/structure/mirror/directional/west,
/obj/effect/turf_decal/siding/white{
	dir = 4
	},
/turf/open/floor/iron/freezer,
/area/misc/condo)
"xb" = (
/obj/effect/turf_decal/siding/wood{
	dir = 8
	},
/turf/open/floor/wood/parquet,
/area/misc/condo)
"yd" = (
/obj/effect/turf_decal/siding/wood{
	dir = 1
	},
/obj/structure/sign/painting/large/library{
	dir = 1
	},
/turf/open/floor/wood/tile,
/area/misc/condo)
"zg" = (
/obj/effect/turf_decal/siding/wood,
/turf/open/floor/wood/tile,
/area/misc/condo)
"zG" = (
/obj/structure/bed/double,
/obj/effect/spawner/random/bedsheet/double,
/obj/effect/turf_decal/siding/wood{
	dir = 4
	},
/turf/open/floor/wood/parquet,
/area/misc/condo)
"BC" = (
/obj/structure/flora/bush/grassy/style_random,
/obj/structure/flora/bush/flowers_br/style_3,
/obj/structure/window{
	dir = 8
	},
/turf/open/floor/grass,
/area/misc/condo)
"BF" = (
/obj/effect/turf_decal/siding/wideplating_new/light{
	dir = 9
	},
/obj/structure/closet/crate/bin,
/turf/open/floor/mineral/titanium/tiled/white,
/area/misc/condo)
"Cn" = (
/obj/effect/turf_decal/siding/wood/corner{
	dir = 8
	},
/obj/effect/turf_decal/siding/wood/corner{
	dir = 1
	},
/turf/open/floor/wood/tile,
/area/misc/condo)
"Co" = (
/obj/structure/sign/painting/library,
/turf/closed/wall,
/area/misc/condo)
"Dk" = (
/obj/structure/curtain,
/turf/open/floor/iron/freezer,
/area/misc/condo)
"EB" = (
/obj/structure/chair/sofa/corp/right,
/obj/structure/sign/poster/random/directional/north,
/turf/open/floor/carpet,
/area/misc/condo)
"FD" = (
/obj/structure/sink/kitchen/directional/west,
/turf/open/floor/iron/kitchen,
/area/misc/condo)
"FQ" = (
/turf/closed/wall,
/area/misc/condo)
"Gy" = (
/turf/open/space/bluespace,
/area/misc/condo)
"Gz" = (
/obj/effect/turf_decal/siding/wood{
	dir = 1
	},
/obj/structure/closet/mini_fridge{
	density = 0;
	pixel_y = 8
	},
/obj/item/storage/cans/sixbeer,
/turf/open/floor/wood/tile,
/area/misc/condo)
"GJ" = (
/obj/machinery/computer/security/telescreen/entertainment/directional/east,
/obj/effect/turf_decal/siding/wood{
	dir = 6
	},
/obj/machinery/jukebox{
	req_access = null
	},
/turf/open/floor/wood/parquet,
/area/misc/condo)
"GT" = (
/obj/structure/chair/stool/bar/directional/west,
/turf/open/floor/wood/tile,
/area/misc/condo)
"Iy" = (
/obj/machinery/door/morgue,
/turf/open/floor/wood/parquet,
/area/misc/condo)
"IE" = (
/obj/item/kirbyplants/random,
/obj/structure/sign/poster/random/directional/north,
/turf/open/floor/iron/kitchen,
/area/misc/condo)
"Ji" = (
/obj/structure/falsewall,
/turf/open/floor/plating,
/area/misc/condo)
"JB" = (
/obj/item/toy/plush/skyrat/chunko/inessa,
/turf/open/floor/carpet,
/area/misc/condo)
"JZ" = (
/turf/open/floor/plating,
/area/misc/condo)
"Km" = (
/turf/open/floor/carpet,
/area/misc/condo)
"KN" = (
/obj/structure/chair/stool/bar/directional/north,
/turf/open/floor/wood/tile,
/area/misc/condo)
"KX" = (
/obj/structure/chair/comfy/brown{
	dir = 4
	},
/turf/open/floor/carpet,
/area/misc/condo)
"LL" = (
/obj/structure/closet/secure_closet/wall{
	pixel_y = 32
	},
/obj/effect/turf_decal/tile/neutral/diagonal_edge,
/obj/effect/turf_decal/siding/white{
	dir = 4
	},
/turf/open/floor/iron/freezer,
/area/misc/condo)
"Mv" = (
/obj/structure/chair{
	dir = 1
	},
/turf/open/floor/iron/kitchen,
/area/misc/condo)
"Nf" = (
/obj/structure/table/wood/poker,
/obj/item/toy/cards/deck,
/turf/open/floor/carpet,
/area/misc/condo)
"Ng" = (
/obj/machinery/computer{
	dir = 8
	},
/turf/open/floor/carpet/donk,
/area/misc/condo)
"OT" = (
/obj/effect/turf_decal/siding/wood/corner,
/turf/open/floor/wood/tile,
/area/misc/condo)
"PL" = (
/obj/item/kitchen/spoon,
/obj/item/kitchen/spoon,
/obj/item/kitchen/spoon,
/obj/item/kitchen/spoon,
/obj/item/kitchen/fork,
/obj/item/kitchen/fork,
/obj/item/kitchen/fork,
/obj/item/kitchen/fork,
/obj/effect/spawner/random/food_or_drink/three_course_meal,
/obj/effect/spawner/random/food_or_drink/three_course_meal,
/obj/effect/spawner/random/food_or_drink/three_course_meal,
/obj/effect/spawner/random/food_or_drink/three_course_meal,
/obj/effect/spawner/random/food_or_drink/three_course_meal,
/obj/effect/spawner/random/food_or_drink/three_course_meal,
/obj/effect/spawner/random/food_or_drink/three_course_meal,
/obj/item/plate,
/obj/item/plate,
/obj/item/plate,
/obj/item/plate,
/obj/item/storage/cans/sixbeer,
/obj/item/reagent_containers/cup/glass/drinkingglass,
/obj/item/reagent_containers/cup/glass/drinkingglass,
/obj/item/reagent_containers/cup/glass/drinkingglass,
/obj/item/reagent_containers/cup/glass/drinkingglass,
/obj/item/storage/fancy/pickles_jar,
/obj/structure/closet/secure_closet/freezer/kitchen/mining{
	storage_capacity = 60
	},
/obj/effect/spawner/random/food_or_drink/donkpockets,
/turf/open/floor/iron/kitchen,
/area/misc/condo)
"QW" = (
/obj/effect/turf_decal/siding/wood{
	dir = 8
	},
/obj/structure/aquarium/prefilled,
/turf/open/floor/wood/tile,
/area/misc/condo)
"QX" = (
/turf/closed/indestructible/steel,
/area/misc/condo)
"Rg" = (
/obj/structure/chair/sofa/corp/corner,
/obj/machinery/light/warm/directional/east,
/turf/open/floor/carpet,
/area/misc/condo)
"Sb" = (
/obj/structure/railing{
	dir = 8
	},
/obj/structure/sign/poster/random/directional/north,
/obj/effect/spawner/liquids_spawner,
/turf/open/floor/iron/pool/cobble/corner{
	dir = 1
	},
/area/misc/condo)
"Sk" = (
/obj/structure/closet/cabinet,
/obj/effect/turf_decal/siding/wood{
	dir = 10
	},
/turf/open/floor/wood/parquet,
/area/misc/condo)
"So" = (
/obj/effect/spawner/surgery_tray/full,
/turf/open/floor/plating,
/area/misc/condo)
"Uq" = (
/obj/effect/turf_decal/siding/wood{
	dir = 4
	},
/obj/effect/turf_decal/siding/wood/corner{
	dir = 8
	},
/turf/open/floor/wood/tile,
/area/misc/condo)
"Vu" = (
/obj/structure/chair{
	dir = 8
	},
/turf/open/floor/iron/kitchen,
/area/misc/condo)
"Vv" = (
/obj/structure/chair/office{
	dir = 4
	},
/obj/effect/turf_decal/siding/wood{
	dir = 10
	},
/turf/open/floor/wood/parquet,
/area/misc/condo)
"We" = (
/obj/structure/bookcase/random,
/obj/effect/turf_decal/siding/wood{
	dir = 1
	},
/turf/open/floor/wood/parquet,
/area/misc/condo)
"Xj" = (
/turf/open/floor/carpet/donk,
/area/misc/condo)
"XO" = (
/obj/structure/chair/stool/bar/directional/south,
/obj/structure/sign/poster/random/directional/north,
/obj/effect/turf_decal/siding/wood{
	dir = 1
	},
/turf/open/floor/wood/tile,
/area/misc/condo)
"Zw" = (
/obj/machinery/light_switch/directional/north,
/obj/effect/turf_decal/siding/wideplating_new/light{
	dir = 8
	},
/obj/structure/table/reinforced,
/obj/machinery/microwave{
	pixel_x = -2;
	pixel_y = 6
	},
/turf/open/floor/mineral/titanium/tiled/white,
/area/misc/condo)

(1,1,1) = {"
Gy
Gy
Gy
Gy
Gy
Gy
Gy
Gy
Gy
Gy
Gy
Gy
Gy
Gy
Gy
"}
(2,1,1) = {"
Gy
QX
QX
nn
QX
QX
pN
QX
QX
QX
QX
QX
QX
QX
Gy
"}
(3,1,1) = {"
Gy
QX
mc
xb
Vv
FQ
aL
Sk
FQ
IE
kR
py
cq
QX
Gy
"}
(4,1,1) = {"
Gy
QX
We
Xj
Ng
FQ
jt
dG
FQ
qL
qD
Mv
pj
QX
Gy
"}
(5,1,1) = {"
Gy
QX
nV
Xj
Xj
Iy
mE
mE
nh
lj
Vu
lj
lj
QX
Gy
"}
(6,1,1) = {"
Gy
QX
mh
Xj
uB
FQ
nJ
mE
nh
lj
lj
lj
PL
QX
Gy
"}
(7,1,1) = {"
Gy
QX
lw
zG
sz
FQ
mE
mE
FQ
Zw
ml
FD
BF
QX
Gy
"}
(8,1,1) = {"
Gy
QX
FQ
FQ
FQ
FQ
Iy
FQ
FQ
FQ
FQ
FQ
FQ
QX
Gy
"}
(9,1,1) = {"
Gy
QX
uy
lM
KX
fM
Cn
jL
QW
uz
FQ
ra
tX
QX
Gy
"}
(10,1,1) = {"
Gy
QX
XO
at
Nf
KN
OT
ou
ou
Uq
iW
cl
ew
QX
Gy
"}
(11,1,1) = {"
Gy
QX
yd
GT
GT
mo
zg
FQ
FQ
FQ
FQ
Dk
FQ
QX
Gy
"}
(12,1,1) = {"
Gy
QX
Gz
mo
mo
Km
Km
Co
qW
eE
FQ
LL
wr
QX
Gy
"}
(13,1,1) = {"
Gy
QX
EB
Km
ju
JB
Km
Ji
JZ
lo
FQ
Sb
jz
QX
Gy
"}
(14,1,1) = {"
Gy
QX
Rg
vv
GJ
ur
BC
FQ
dO
So
FQ
fY
aW
QX
Gy
"}
(15,1,1) = {"
Gy
QX
QX
nn
QX
QX
QX
QX
QX
QX
QX
QX
QX
QX
Gy
"}
(16,1,1) = {"
Gy
Gy
Gy
Gy
Gy
Gy
Gy
Gy
Gy
Gy
Gy
Gy
Gy
Gy
Gy
"}
