//MAP CONVERTED BY dmm2tgm.py THIS HEADER COMMENT PREVENTS RECONVERSION, DO NOT REMOVE
"cw" = (
/obj/machinery/door/airlock/sandstone{
	name = "Beach Cabin"
	},
/obj/effect/turf_decal/sand,
/turf/open/floor/wood,
/area/misc/condo)
"ec" = (
/obj/machinery/door/morgue,
/turf/open/floor/wood,
/area/misc/condo)
"fb" = (
/turf/open/misc/beach/sand,
/area/misc/condo)
"fc" = (
/obj/effect/turf_decal/siding/wood{
	dir = 4
	},
/obj/structure/chair/comfy/teal{
	dir = 8
	},
/obj/machinery/light_switch/directional/east,
/turf/open/floor/wood/large,
/area/misc/condo)
"fP" = (
/obj/effect/turf_decal/siding/wood{
	dir = 6
	},
/obj/structure/closet/cabinet,
/obj/item/hairbrush{
	pixel_x = 2;
	pixel_y = 3
	},
/obj/item/serviette_pack,
/turf/open/floor/wood/large,
/area/misc/condo)
"gx" = (
/turf/open/misc/beach/coast{
	dir = 1
	},
/area/misc/condo)
"ih" = (
/obj/item/kirbyplants/random,
/obj/effect/turf_decal/siding/wood{
	dir = 10
	},
/turf/open/floor/wood,
/area/misc/condo)
"iF" = (
/obj/effect/turf_decal/siding/wood{
	dir = 10
	},
/turf/open/floor/wood/large,
/area/misc/condo)
"lZ" = (
/obj/effect/turf_decal/siding/wood/corner,
/turf/open/floor/wood/parquet,
/area/misc/condo)
"md" = (
/turf/open/misc/beach/coast/corner{
	dir = 4
	},
/area/misc/condo)
"mD" = (
/obj/machinery/jukebox{
	req_access = null
	},
/turf/open/misc/beach/sand,
/area/misc/condo)
"mM" = (
/obj/effect/turf_decal/siding/wood,
/obj/item/kirbyplants/random,
/turf/open/floor/wood,
/area/misc/condo)
"no" = (
/obj/structure/chair{
	dir = 8
	},
/obj/effect/turf_decal/siding/wood{
	dir = 5
	},
/turf/open/floor/wood/parquet,
/area/misc/condo)
"nB" = (
/obj/effect/turf_decal/siding/wood{
	dir = 9
	},
/obj/structure/sign/painting/large/library{
	dir = 1
	},
/turf/open/floor/wood,
/area/misc/condo)
"oz" = (
/obj/effect/light_emitter/interlink,
/turf/open/misc/beach/coast/corner{
	dir = 8
	},
/area/misc/condo)
"oC" = (
/obj/structure/toilet{
	dir = 4
	},
/obj/structure/window/spawner/directional/north,
/turf/open/indestructible/bathroom,
/area/misc/condo)
"oU" = (
/obj/item/toy/beach_ball,
/obj/effect/light_emitter/interlink,
/turf/open/water/beach,
/area/misc/condo)
"pk" = (
/obj/effect/light_emitter/interlink,
/turf/open/misc/beach/coast/corner{
	dir = 4
	},
/area/misc/condo)
"py" = (
/obj/structure/chair/sofa/left{
	dir = 1
	},
/obj/effect/turf_decal/sand,
/turf/open/misc/beach/sand,
/area/misc/condo)
"pO" = (
/obj/effect/turf_decal/siding/wood{
	dir = 5
	},
/obj/item/flashlight/lamp/green{
	pixel_x = 5;
	pixel_y = 14
	},
/obj/structure/table/wood,
/turf/open/floor/wood/large,
/area/misc/condo)
"rJ" = (
/obj/effect/turf_decal/siding/wood{
	dir = 4
	},
/turf/open/floor/wood/parquet,
/area/misc/condo)
"sh" = (
/turf/open/floor/wood/large,
/area/misc/condo)
"ss" = (
/obj/effect/turf_decal/siding/wood{
	dir = 6
	},
/obj/machinery/vending/dorms,
/turf/open/floor/wood,
/area/misc/condo)
"tM" = (
/obj/machinery/shower/directional/east,
/obj/structure/drain/big,
/obj/item/soap/deluxe,
/obj/structure/curtain,
/turf/open/indestructible/bathroom,
/area/misc/condo)
"uc" = (
/obj/structure/chair/sofa/middle{
	dir = 1
	},
/obj/effect/turf_decal/sand,
/turf/open/misc/beach/sand,
/area/misc/condo)
"uZ" = (
/obj/machinery/light/floor{
	alpha = 0;
	invisibility = 100;
	light_range = 10;
	nightshift_light_power = 10
	},
/turf/open/indestructible/bathroom,
/area/misc/condo)
"vh" = (
/obj/effect/light_emitter/interlink,
/turf/open/misc/beach/coast{
	dir = 5
	},
/area/misc/condo)
"vQ" = (
/obj/effect/turf_decal/siding/wood,
/turf/open/floor/carpet/lone,
/area/misc/condo)
"yE" = (
/obj/effect/light_emitter/interlink,
/turf/open/misc/beach/coast{
	dir = 1
	},
/area/misc/condo)
"yF" = (
/turf/closed/wall/mineral/sandstone,
/area/misc/condo)
"Bb" = (
/obj/structure/table/reinforced,
/obj/effect/turf_decal/siding/white{
	dir = 1
	},
/obj/item/knife/kitchen,
/turf/open/floor/iron/kitchen,
/area/misc/condo)
"BL" = (
/obj/effect/turf_decal/siding/wood{
	dir = 9
	},
/obj/structure/bed/dogbed,
/obj/item/toy/plush/shark,
/turf/open/floor/wood/large,
/area/misc/condo)
"Cm" = (
/obj/structure/closet/crate/bin,
/obj/effect/turf_decal/siding/wood{
	dir = 10
	},
/obj/machinery/light_switch/directional/west,
/turf/open/floor/wood/parquet,
/area/misc/condo)
"CA" = (
/obj/effect/turf_decal/siding/wood{
	dir = 5
	},
/obj/item/kirbyplants/random,
/turf/open/floor/wood/parquet,
/area/misc/condo)
"CI" = (
/obj/effect/light_emitter/interlink,
/turf/open/misc/beach/sand,
/area/misc/condo)
"Eh" = (
/obj/effect/turf_decal/siding/wood/corner{
	dir = 1
	},
/turf/open/floor/wood/large,
/area/misc/condo)
"Fg" = (
/obj/effect/turf_decal/siding/wood,
/turf/open/floor/wood/parquet,
/area/misc/condo)
"Fq" = (
/obj/structure/chair{
	dir = 8
	},
/obj/effect/turf_decal/siding/wood/corner{
	dir = 4
	},
/turf/open/floor/wood/parquet,
/area/misc/condo)
"Hd" = (
/obj/structure/chair{
	dir = 4
	},
/obj/effect/turf_decal/siding/wood{
	dir = 8
	},
/turf/open/floor/wood/parquet,
/area/misc/condo)
"Hg" = (
/turf/closed/wall/mineral/wood,
/area/misc/condo)
"Ho" = (
/turf/open/floor/carpet/cyan,
/area/misc/condo)
"HJ" = (
/obj/effect/light_emitter/interlink,
/obj/item/toy/plush/carpplushie,
/turf/open/water/beach,
/area/misc/condo)
"JH" = (
/obj/effect/turf_decal/siding/wood{
	dir = 6
	},
/turf/open/floor/wood/parquet,
/area/misc/condo)
"Kz" = (
/obj/structure/sink/directional/north,
/obj/structure/mirror/directional/south,
/turf/open/indestructible/bathroom,
/area/misc/condo)
"Lf" = (
/obj/effect/turf_decal/siding/wood{
	dir = 1
	},
/turf/open/floor/wood,
/area/misc/condo)
"LL" = (
/obj/structure/fluff/beach_umbrella,
/obj/effect/light_emitter/interlink,
/turf/open/misc/beach/coast{
	dir = 1
	},
/area/misc/condo)
"LR" = (
/obj/structure/closet/secure_closet/freezer/kitchen/all_access,
/obj/effect/spawner/random/food_or_drink/three_course_meal,
/obj/effect/spawner/random/food_or_drink/three_course_meal,
/obj/effect/spawner/random/food_or_drink/three_course_meal,
/obj/effect/spawner/random/food_or_drink/three_course_meal,
/obj/effect/turf_decal/siding/wood{
	dir = 6
	},
/turf/open/floor/wood/parquet,
/area/misc/condo)
"Mb" = (
/obj/structure/dresser,
/obj/effect/turf_decal/siding/wood{
	dir = 9
	},
/turf/open/floor/wood/large,
/area/misc/condo)
"Me" = (
/turf/open/misc/beach/coast{
	dir = 4
	},
/area/misc/condo)
"NQ" = (
/obj/structure/bed/double/pod,
/obj/effect/turf_decal/siding/wood{
	dir = 1
	},
/obj/effect/spawner/random/bedsheet/double,
/turf/open/floor/wood/large,
/area/misc/condo)
"Od" = (
/obj/structure/chair/sofa/right{
	dir = 1
	},
/obj/effect/turf_decal/sand,
/turf/open/misc/beach/sand,
/area/misc/condo)
"Oj" = (
/obj/effect/turf_decal/siding/wood,
/turf/open/floor/wood/large,
/area/misc/condo)
"Pk" = (
/obj/machinery/door/airlock/wood,
/turf/open/floor/wood,
/area/misc/condo)
"Po" = (
/obj/structure/chair{
	dir = 4
	},
/obj/effect/turf_decal/siding/wood{
	dir = 9
	},
/turf/open/floor/wood/parquet,
/area/misc/condo)
"PT" = (
/obj/effect/turf_decal/siding/wood{
	dir = 5
	},
/obj/machinery/light_switch/directional/north,
/turf/open/floor/wood,
/area/misc/condo)
"Ro" = (
/obj/effect/turf_decal/siding/wood{
	dir = 1
	},
/obj/machinery/light/warm/directional/north,
/turf/open/floor/wood,
/area/misc/condo)
"RE" = (
/obj/structure/table/wood,
/obj/item/rag,
/obj/merge_conflict_marker{
	name = "---Merge Conflict Marker---";
	
	desc = "A best-effort merge was performed. You must resolve this conflict yourself (manually) and remove this object once complete."
	},
/obj/structure/table/wood,
/turf/open/floor/wood/parquet,
/area/misc/condo)
"SE" = (
/obj/effect/turf_decal/siding/wood{
	dir = 8
	},
/obj/machinery/light/warm/directional/west,
/turf/open/floor/wood/parquet,
/area/misc/condo)
"Tb" = (
/obj/effect/light_emitter/interlink,
/turf/open/misc/beach/coast{
	dir = 9
	},
/area/misc/condo)
"Th" = (
/obj/structure/closet/cabinet,
/obj/effect/turf_decal/siding/wood/end{
	dir = 8
	},
/obj/machinery/room_controller/directional/north,
/turf/open/floor/wood/large,
/area/misc/condo)
"Tr" = (
/obj/effect/turf_decal/siding/white{
	dir = 9
	},
/obj/machinery/light/floor{
	alpha = 0;
	invisibility = 100;
	light_range = 10;
	nightshift_light_power = 10
	},
/turf/open/floor/iron/kitchen,
/area/misc/condo)
"Tz" = (
/turf/closed/indestructible/hoteldoor{
	icon_state = "door_closed";
	icon = 'icons/obj/doors/puzzledoor/default.dmi'
	},
/area/misc/condo)
"UD" = (
/obj/effect/turf_decal/siding/wood,
/obj/machinery/light/warm/dim/directional/south,
/turf/open/floor/wood/large,
/area/misc/condo)
"VY" = (
/obj/effect/turf_decal/siding{
	dir = 4
	},
/obj/machinery/door/morgue,
/turf/open/indestructible/bathroom,
/area/misc/condo)
"We" = (
/obj/effect/turf_decal/siding/wood{
	dir = 8
	},
/turf/open/floor/wood/parquet,
/area/misc/condo)
"Wq" = (
/obj/structure/curtain/cloth/fancy,
/turf/closed/indestructible/fakeglass,
/area/misc/condo)
"Wz" = (
/turf/open/misc/beach/coast/corner{
	dir = 8
	},
/area/misc/condo)
"Xp" = (
/obj/effect/light_emitter/interlink,
/turf/open/water/beach,
/area/misc/condo)
"Xs" = (
/obj/structure/table/reinforced,
/obj/machinery/microwave{
	pixel_x = -2;
	pixel_y = 6
	},
/turf/open/floor/iron/kitchen,
/area/misc/condo)
"Xz" = (
/obj/structure/table/wood,
/obj/effect/turf_decal/siding/wood{
	dir = 1
	},
/obj/item/pizzabox/margherita{
	pixel_y = 11
	},
/obj/item/storage/cans/sixbeer,
/turf/open/floor/wood/parquet,
/area/misc/condo)
"Zp" = (
/obj/effect/turf_decal/siding/wood/end{
	dir = 4
	},
/obj/machinery/light/floor,
/obj/machinery/light_switch/directional/south,
/turf/open/floor/wood/large,
/area/misc/condo)
"Zs" = (
/obj/effect/turf_decal/siding/white{
	dir = 8
	},
/turf/open/floor/iron/kitchen,
/area/misc/condo)
"ZQ" = (
/turf/closed/indestructible/rock,
/area/misc/condo)
"ZV" = (
/turf/open/floor/iron/stairs/old{
	dir = 1
	},
/area/misc/condo)

(1,1,1) = {"
ZQ
ZQ
ZQ
ZQ
ZQ
ZQ
ZQ
ZQ
ZQ
ZQ
ZQ
ZQ
ZQ
ZQ
ZQ
"}
(2,1,1) = {"
ZQ
Xp
Xp
Xp
Xp
vh
oz
fb
yF
yF
yF
yF
yF
yF
ZQ
"}
(3,1,1) = {"
ZQ
Xp
HJ
Xp
Xp
Tb
pk
fb
yF
Th
Hg
tM
oC
yF
ZQ
"}
(4,1,1) = {"
ZQ
Xp
Xp
Xp
Xp
yE
fb
ZV
cw
Zp
Hg
uZ
Kz
yF
ZQ
"}
(5,1,1) = {"
ZQ
Xp
Xp
Xp
Tb
pk
fb
yF
yF
ec
Hg
VY
Hg
yF
ZQ
"}
(6,1,1) = {"
ZQ
Xp
Xp
Xp
yE
fb
yF
yF
Mb
iF
Hg
nB
ih
yF
ZQ
"}
(7,1,1) = {"
ZQ
Xp
Xp
Tb
md
fb
Wq
BL
Eh
UD
Hg
Ro
vQ
Tz
ZQ
"}
(8,1,1) = {"
ZQ
Xp
Xp
LL
Ho
Ho
Wq
NQ
sh
Oj
Pk
Lf
mM
yF
ZQ
"}
(9,1,1) = {"
ZQ
Xp
Xp
vh
Me
Wz
Wq
pO
fc
fP
Hg
PT
ss
yF
ZQ
"}
(10,1,1) = {"
ZQ
Xp
Xp
Xp
Xp
gx
yF
yF
Hg
Hg
Hg
ec
Hg
yF
ZQ
"}
(11,1,1) = {"
ZQ
Xp
Xp
Xp
Xp
gx
py
Wq
Po
Hd
SE
We
Cm
yF
ZQ
"}
(12,1,1) = {"
ZQ
Xp
Xp
Xp
Xp
yE
uc
Wq
Xz
RE
lZ
rJ
JH
yF
ZQ
"}
(13,1,1) = {"
ZQ
Xp
oU
Xp
Xp
yE
Od
Wq
no
Fq
Fg
Tr
Zs
yF
ZQ
"}
(14,1,1) = {"
ZQ
Xp
Xp
Xp
Tb
pk
mD
yF
yF
CA
LR
Bb
Xs
yF
ZQ
"}
(15,1,1) = {"
ZQ
Xp
Xp
Tb
pk
CI
CI
fb
yF
yF
yF
yF
yF
yF
ZQ
"}
(16,1,1) = {"
ZQ
ZQ
ZQ
ZQ
ZQ
ZQ
ZQ
ZQ
ZQ
ZQ
ZQ
ZQ
ZQ
ZQ
ZQ
"}
