//MAP CONVERTED BY dmm2tgm.py THIS HEADER COMMENT PREVENTS RECONVERSION, DO NOT REMOVE
"am" = (
/obj/structure/showcase/fakeid{
	dir = 1;
	name = "\improper CentComm Oversight Console";
	desc = "You can use this to watch the watchers."
	},
/turf/open/indestructible/hotelwood,
/area/misc/condo)
"av" = (
/obj/effect/turf_decal/tile/neutral/fourcorners,
/obj/machinery/photocopier/gratis,
/obj/machinery/light_switch/directional/south,
/turf/open/indestructible/dark,
/area/misc/condo)
"aL" = (
/obj/structure/table/wood,
/obj/effect/turf_decal/tile/neutral/fourcorners,
/obj/item/folder/blue{
	pixel_x = -3;
	pixel_y = 5
	},
/obj/item/folder/blue{
	pixel_x = -6;
	pixel_y = 1
	},
/turf/open/indestructible/dark,
/area/misc/condo)
"bp" = (
/obj/effect/turf_decal/siding/wood{
	dir = 6
	},
/obj/effect/turf_decal/siding/wood/corner{
	dir = 1
	},
/turf/open/indestructible/hotelwood,
/area/misc/condo)
"cH" = (
/turf/closed/indestructible/riveted,
/area/misc/condo)
"du" = (
/obj/structure/sign/painting{
	pixel_y = 32
	},
/obj/item/banner/command/mundane,
/obj/effect/turf_decal/tile/neutral/fourcorners,
/obj/machinery/light/directional/north,
/obj/effect/turf_decal/siding/wood{
	dir = 4
	},
/turf/open/indestructible/dark,
/area/misc/condo)
"dy" = (
/obj/structure/table/wood,
/obj/item/lighter{
	color = "#d4af37";
	desc = "A gold-plated Zippo lighter";
	name = "Golden Lighter";
	pixel_x = 10;
	pixel_y = -15
	},
/obj/item/cigarette/cigar/premium{
	pixel_x = -6
	},
/obj/item/cigarette/cigar/havana{
	pixel_x = 3;
	pixel_y = 1
	},
/obj/item/cigarette/cigar/premium{
	pixel_x = 9;
	pixel_y = -2
	},
/obj/item/reagent_containers/cup/glass/drinkingglass{
	pixel_x = -8;
	pixel_y = 15
	},
/obj/item/reagent_containers/cup/glass/drinkingglass{
	pixel_x = 1;
	pixel_y = 15
	},
/obj/item/reagent_containers/cup/glass/drinkingglass{
	pixel_x = 10;
	pixel_y = 15
	},
/turf/open/indestructible/hotelwood,
/area/misc/condo)
"iA" = (
/obj/machinery/jukebox{
	icon = 'modular_skyrat/modules/aesthetics/intercom/icons/intercom.dmi';
	icon_state = "intercom";
	pixel_y = -10;
	name = "Enviroment Sound System";
	desc = "It's hip to be square!"
	},
/turf/closed/indestructible/riveted,
/area/misc/condo)
"iM" = (
/obj/structure/table/wood,
/obj/item/storage/fancy/donut_box{
	pixel_y = 12
	},
/obj/item/storage/fancy/donut_box{
	pixel_y = 1
	},
/obj/effect/turf_decal/tile/neutral/full,
/turf/open/indestructible/dark/smooth_large,
/area/misc/condo)
"iU" = (
/obj/structure/table/wood,
/obj/machinery{
	icon = 'modular_skyrat/modules/aesthetics/intercom/icons/intercom.dmi';
	icon_state = "intercom";
	name = "Intercom";
	pixel_y = -1
	},
/turf/open/indestructible/carpet,
/area/misc/condo)
"jC" = (
/obj/structure/table/wood,
/obj/effect/turf_decal/tile/neutral/fourcorners,
/obj/item/stamp{
	pixel_x = -9;
	pixel_y = 11
	},
/obj/item/stamp/denied{
	pixel_y = 6;
	pixel_x = -9
	},
/obj/item/stamp/void{
	pixel_x = -9;
	pixel_y = 0
	},
/turf/open/indestructible/dark,
/area/misc/condo)
"jZ" = (
/obj/effect/turf_decal/tile/neutral/full,
/obj/structure/table/wood,
/obj/item/storage/box/drinkingglasses{
	pixel_y = 8;
	pixel_x = 2
	},
/obj/item/reagent_containers/cup/glass/coffee{
	pixel_x = -12;
	pixel_y = 12
	},
/obj/item/reagent_containers/cup/glass/coffee{
	pixel_x = -12;
	pixel_y = 5
	},
/obj/item/reagent_containers/cup/glass/coffee{
	pixel_x = -12;
	pixel_y = -1
	},
/obj/item/reagent_containers/condiment/pack/sugar{
	pixel_x = 11;
	pixel_y = -1
	},
/obj/item/reagent_containers/condiment/pack/sugar{
	pixel_x = 4;
	pixel_y = -1
	},
/obj/item/reagent_containers/condiment/pack/sugar{
	pixel_x = -4;
	pixel_y = -1
	},
/turf/open/indestructible/dark/smooth_large,
/area/misc/condo)
"kq" = (
/obj/structure/bookcase{
	icon_state = "book-5"
	},
/turf/open/indestructible/hotelwood,
/area/misc/condo)
"lj" = (
/obj/effect/turf_decal/siding/wood{
	dir = 10
	},
/obj/effect/turf_decal/siding/wood/corner{
	dir = 4
	},
/turf/open/indestructible/hotelwood,
/area/misc/condo)
"lQ" = (
/obj/structure/table/wood,
/obj/item/paper_bin{
	pixel_y = 4;
	pixel_x = -4
	},
/obj/item/pen/fountain/captain{
	pixel_y = 4;
	pixel_x = -5;
	name = "Golden Fountain Pen"
	},
/obj/item/book/manual/wiki/security_space_law{
	pixel_y = 3;
	pixel_x = 10
	},
/obj/effect/turf_decal/tile/neutral/fourcorners,
/turf/open/indestructible/dark,
/area/misc/condo)
"mg" = (
/obj/machinery/light/directional/north,
/obj/structure/sign/poster/official/work_for_a_future/directional/north,
/obj/structure/bookcase{
	icon_state = "book-5"
	},
/turf/open/indestructible/dark,
/area/misc/condo)
"nq" = (
/obj/structure/chair/comfy/beige,
/turf/open/indestructible/carpet,
/area/misc/condo)
"nz" = (
/obj/item/kirbyplants/organic/plant22,
/obj/effect/turf_decal/tile/dark_blue/opposingcorners,
/turf/open/indestructible/dark,
/area/misc/condo)
"oL" = (
/obj/structure/table/wood,
/obj/item/paper_bin{
	pixel_y = 3
	},
/obj/item/pen/fountain{
	pixel_y = 4
	},
/turf/open/indestructible/carpet,
/area/misc/condo)
"pa" = (
/obj/structure/table/wood,
/obj/item/reagent_containers/cup/glass/bottle/cognac{
	pixel_y = 18;
	pixel_x = -7
	},
/obj/item/reagent_containers/cup/glass/bottle/whiskey{
	pixel_x = 7;
	pixel_y = 16
	},
/obj/item/reagent_containers/cup/glass/flask/gold{
	pixel_x = 5;
	name = "Golden Flask";
	desc = "A gold flask belonging to the one who owns this office."
	},
/turf/open/indestructible/hotelwood,
/area/misc/condo)
"pE" = (
/obj/effect/turf_decal/tile/neutral/full,
/obj/machinery/vending/dorms,
/turf/open/indestructible/dark/smooth_large,
/area/misc/condo)
"rr" = (
/obj/effect/turf_decal/tile/dark_blue/opposingcorners,
/turf/open/indestructible/dark,
/area/misc/condo)
"rv" = (
/obj/effect/turf_decal/siding/wood{
	dir = 8
	},
/obj/effect/turf_decal/siding/wood{
	dir = 4
	},
/turf/open/indestructible/hotelwood,
/area/misc/condo)
"tu" = (
/obj/effect/turf_decal/siding/wood{
	dir = 4
	},
/obj/effect/turf_decal/siding/wood{
	dir = 8
	},
/turf/open/indestructible/hotelwood,
/area/misc/condo)
"uI" = (
/obj/structure/chair/comfy/beige{
	dir = 1
	},
/turf/open/indestructible/carpet,
/area/misc/condo)
"vq" = (
/obj/machinery/light/floor,
/turf/open/indestructible/hotelwood,
/area/misc/condo)
"wh" = (
/turf/closed/indestructible/fakeglass,
/area/misc/condo)
"wL" = (
/turf/closed/indestructible/hoteldoor{
	icon_state = "door_closed";
	icon = 'icons/obj/doors/puzzledoor/default.dmi'
	},
/area/misc/condo)
"xs" = (
/obj/effect/turf_decal/tile/neutral/fourcorners,
/obj/effect/turf_decal/siding/wood,
/turf/open/indestructible/dark,
/area/misc/condo)
"yj" = (
/obj/effect/turf_decal/siding/wood{
	dir = 1
	},
/obj/effect/turf_decal/siding/wood,
/turf/open/indestructible/hotelwood,
/area/misc/condo)
"yp" = (
/turf/open/space/basic,
/area/misc/condo)
"Ag" = (
/obj/structure/window/reinforced/survival_pod/spawner/directional/north,
/obj/effect/turf_decal/tile/neutral/full,
/obj/structure/table/wood/fancy/black,
/obj/item/sign/flag/galfed{
	pixel_y = 3;
	pixel_x = 4
	},
/obj/item/sign/flag/nanotrasen{
	pixel_y = 1
	},
/turf/open/indestructible/dark/smooth_large,
/area/misc/condo)
"Av" = (
/obj/item/banner/command/mundane,
/obj/machinery/room_controller/directional/north,
/turf/open/indestructible/dark/smooth_large,
/area/misc/condo)
"BG" = (
/obj/item/banner/command/mundane,
/obj/machinery/light_switch/directional/south,
/turf/open/indestructible/dark/smooth_large,
/area/misc/condo)
"CI" = (
/obj/structure/showcase/fakeid{
	name = "\improper CentComm Communications Console";
	desc = "You can use this to communicate... if you know the password."
	},
/turf/open/indestructible/hotelwood,
/area/misc/condo)
"CV" = (
/obj/structure/table/wood,
/obj/item/storage/fancy/cigarettes/cigars/cohiba{
	pixel_x = -2;
	pixel_y = 15
	},
/obj/item/storage/fancy/cigarettes/cigars/havana{
	pixel_x = 2;
	pixel_y = 2
	},
/turf/open/indestructible/hotelwood,
/area/misc/condo)
"DF" = (
/obj/effect/turf_decal/siding/wood,
/obj/effect/turf_decal/siding/wood{
	dir = 1
	},
/turf/open/indestructible/hotelwood,
/area/misc/condo)
"FM" = (
/turf/open/indestructible/hotelwood,
/area/misc/condo)
"GH" = (
/obj/effect/turf_decal/tile/neutral/fourcorners,
/obj/effect/turf_decal/siding/wood{
	dir = 1
	},
/turf/open/indestructible/dark,
/area/misc/condo)
"Jy" = (
/obj/effect/turf_decal/siding/wood{
	dir = 8
	},
/obj/effect/turf_decal/siding/wood{
	dir = 4
	},
/obj/machinery/light/floor,
/turf/open/indestructible/hotelwood,
/area/misc/condo)
"Kb" = (
/obj/effect/turf_decal/tile/neutral/full,
/obj/machinery/vending/cigarette/beach,
/turf/open/indestructible/dark/smooth_large,
/area/misc/condo)
"NU" = (
/obj/structure/table/wood,
/obj/effect/turf_decal/tile/neutral/fourcorners,
/obj/item/phone{
	desc = "Supposedly a direct line to Nanotrasen Central Command. It's not even plugged in.";
	pixel_x = 19;
	pixel_y = -4
	},
/obj/machinery{
	icon = 'modular_skyrat/modules/aesthetics/intercom/icons/intercom.dmi';
	icon_state = "intercom";
	pixel_x = 1;
	name = "Intercom"
	},
/turf/open/indestructible/dark,
/area/misc/condo)
"OR" = (
/obj/structure/window/reinforced/survival_pod/spawner/directional/north,
/obj/structure/showcase/mecha/marauder,
/obj/effect/turf_decal/tile/neutral/full,
/obj/structure/sign/nanotrasen{
	pixel_y = -32
	},
/turf/open/indestructible/dark/smooth_large,
/area/misc/condo)
"OY" = (
/obj/effect/turf_decal/siding/wood{
	dir = 4
	},
/obj/effect/turf_decal/siding/wood{
	dir = 8
	},
/obj/machinery/light/floor,
/turf/open/indestructible/hotelwood,
/area/misc/condo)
"Pq" = (
/obj/structure/table/wood,
/turf/open/indestructible/carpet,
/area/misc/condo)
"PU" = (
/obj/machinery/vending/boozeomat,
/turf/closed/indestructible/riveted,
/area/misc/condo)
"Qi" = (
/obj/effect/turf_decal/tile/neutral/fourcorners,
/turf/open/indestructible/dark,
/area/misc/condo)
"Qk" = (
/obj/effect/turf_decal/siding/wood{
	dir = 9
	},
/obj/effect/turf_decal/siding/wood/corner,
/turf/open/indestructible/hotelwood,
/area/misc/condo)
"QD" = (
/obj/effect/turf_decal/tile/neutral/fourcorners,
/obj/effect/turf_decal/siding/wood{
	dir = 4
	},
/turf/open/indestructible/dark,
/area/misc/condo)
"TW" = (
/obj/effect/turf_decal/tile/neutral/fourcorners,
/obj/structure/chair/comfy{
	dir = 8
	},
/turf/open/indestructible/dark,
/area/misc/condo)
"Vf" = (
/obj/effect/turf_decal/tile/neutral/fourcorners,
/obj/effect/turf_decal/siding/wood/corner{
	dir = 1
	},
/obj/item/kirbyplants/organic/plant10,
/obj/structure/sign/poster/official/fruit_bowl/directional/north,
/turf/open/indestructible/dark,
/area/misc/condo)
"WR" = (
/obj/structure/table/wood,
/obj/effect/turf_decal/tile/neutral/fourcorners,
/obj/machinery/recharger{
	pixel_x = -6;
	pixel_y = 6
	},
/obj/item/flashlight/lamp/green{
	pixel_y = 12;
	pixel_x = 6
	},
/obj/item/cigarette/cigar/havana{
	pixel_x = 5;
	pixel_y = 1
	},
/turf/open/indestructible/dark,
/area/misc/condo)
"WZ" = (
/obj/structure/window/reinforced/survival_pod/spawner/directional/north,
/obj/structure/showcase/perfect_employee,
/obj/effect/turf_decal/tile/neutral/full,
/obj/machinery/light/floor,
/turf/open/indestructible/dark/smooth_large,
/area/misc/condo)
"Xd" = (
/obj/effect/turf_decal/siding/wood{
	dir = 5
	},
/obj/effect/turf_decal/siding/wood/corner{
	dir = 8
	},
/turf/open/indestructible/hotelwood,
/area/misc/condo)
"XH" = (
/obj/effect/turf_decal/tile/neutral/fourcorners,
/obj/effect/turf_decal/siding/wood/corner{
	dir = 8
	},
/obj/item/kirbyplants/organic/plant21,
/obj/structure/sign/poster/official/state_laws/directional/south,
/turf/open/indestructible/dark,
/area/misc/condo)
"Ys" = (
/obj/machinery/light/directional/south,
/obj/structure/sign/poster/official/obey/directional/south,
/obj/structure/bookcase{
	icon_state = "book-5"
	},
/turf/open/indestructible/dark,
/area/misc/condo)
"ZZ" = (
/obj/item/banner/command/mundane,
/obj/effect/turf_decal/tile/neutral/fourcorners,
/obj/machinery/light/directional/south,
/obj/structure/secure_safe/directional/south{
	pixel_y = -22
	},
/obj/effect/turf_decal/siding/wood{
	dir = 4
	},
/turf/open/indestructible/dark,
/area/misc/condo)

(1,1,1) = {"
yp
yp
cH
cH
cH
wh
wh
wL
wh
wh
cH
cH
cH
yp
yp
"}
(2,1,1) = {"
yp
cH
cH
cH
cH
Av
nz
rr
nz
BG
cH
cH
cH
cH
yp
"}
(3,1,1) = {"
yp
cH
cH
cH
mg
rr
rr
rr
rr
rr
Ys
cH
cH
cH
yp
"}
(4,1,1) = {"
yp
cH
cH
Kb
GH
Qk
Jy
rv
Jy
lj
xs
OR
cH
cH
yp
"}
(5,1,1) = {"
yp
cH
cH
pE
GH
yj
nq
Pq
uI
DF
xs
WZ
cH
cH
yp
"}
(6,1,1) = {"
yp
cH
cH
iA
GH
yj
nq
oL
uI
DF
xs
Ag
cH
cH
yp
"}
(7,1,1) = {"
yp
cH
cH
iM
GH
yj
nq
iU
uI
DF
xs
WZ
cH
cH
yp
"}
(8,1,1) = {"
yp
cH
cH
jZ
GH
Xd
OY
tu
OY
bp
xs
OR
cH
cH
yp
"}
(9,1,1) = {"
yp
cH
cH
cH
Vf
Qi
NU
aL
lQ
Qi
XH
cH
cH
cH
yp
"}
(10,1,1) = {"
yp
yp
cH
PU
Qi
Qi
WR
TW
jC
Qi
av
cH
cH
cH
yp
"}
(11,1,1) = {"
yp
yp
cH
cH
du
QD
QD
QD
QD
QD
ZZ
cH
cH
yp
yp
"}
(12,1,1) = {"
yp
yp
cH
cH
kq
CI
FM
vq
FM
am
kq
cH
cH
yp
yp
"}
(13,1,1) = {"
yp
yp
cH
cH
wh
wh
pa
dy
CV
wh
wh
cH
cH
yp
yp
"}
(14,1,1) = {"
yp
yp
yp
yp
yp
wh
wh
wh
wh
wh
yp
yp
yp
yp
yp
"}
(15,1,1) = {"
yp
yp
yp
yp
yp
yp
yp
yp
yp
yp
yp
yp
yp
yp
yp
"}
(16,1,1) = {"
yp
yp
yp
yp
yp
yp
yp
yp
yp
yp
yp
yp
yp
yp
yp
"}
