//MAP CONVERTED BY dmm2tgm.py THIS HEADER COMMENT PREVENTS RECONVERSION, DO NOT REMOVE
"av" = (
/obj/structure/flora/biolumi/mine/weaklight,
/turf/open/misc/dirt/jungle/dark,
/area/misc/condo)
"aX" = (
/obj/structure/barricade/wooden/crude,
/turf/open/misc/dirt/jungle/dark,
/area/misc/condo)
"bd" = (
/obj/structure/flora/rock,
/obj/effect/decal/cleanable/cobweb/cobweb2,
/turf/open/misc/dirt/jungle/dark,
/area/misc/condo)
"bQ" = (
/obj/effect/decal/cleanable/dirt/dust,
/obj/effect/rune/apocalypse,
/turf/open/floor/wood/large,
/area/misc/condo)
"co" = (
/obj/effect/decal/cleanable/cobweb/cobweb2,
/obj/effect/decal/cleanable/dirt/dust,
/turf/open/floor/wood/large,
/area/misc/condo)
"cw" = (
/obj/effect/decal/cleanable/cobweb,
/obj/effect/decal/cleanable/dirt/dust,
/obj/structure/rack/wooden,
/obj/item/clothing/glasses/blindfold{
	pixel_x = 1;
	pixel_y = 5
	},
/obj/item/clothing/mask/muzzle,
/obj/item/restraints/handcuffs{
	icon_state = "brass_manacles";
	name = "cultist restraints";
	pixel_x = 0;
	pixel_y = -9
	},
/turf/open/floor/wood/large,
/area/misc/condo)
"do" = (
/obj/effect/decal/cleanable/dirt/dust,
/turf/open/floor/wood/large,
/area/misc/condo)
"eg" = (
/obj/item/toy/toy_dagger,
/obj/effect/decal/cleanable/dirt/dust,
/obj/structure/table/wood/shuttle_bar,
/turf/open/floor/wood/large,
/area/misc/condo)
"fO" = (
/obj/effect/decal/cleanable/cobweb/cobweb2,
/obj/effect/decal/cleanable/greenglow/ecto,
/turf/open/misc/dirt/jungle/dark,
/area/misc/condo)
"hM" = (
/obj/structure/flora/rock/icy/style_2,
/turf/open/misc/grass/jungle,
/area/misc/condo)
"jk" = (
/obj/structure/bed/double,
/obj/item/bedsheet/cult/double,
/obj/effect/decal/cleanable/dirt/dust,
/turf/open/floor/wood,
/area/misc/condo)
"kb" = (
/obj/structure/flora/rock/pile,
/obj/machinery/vending/dorms,
/turf/open/misc/dirt/jungle/dark,
/area/misc/condo)
"kr" = (
/obj/effect/decal/cleanable/cobweb,
/obj/effect/spawner/random/decoration/glowstick{
	pixel_x = 10;
	pixel_y = 9
	},
/obj/item/flashlight/lantern/on{
	pixel_x = -10;
	pixel_y = 5
	},
/obj/merge_conflict_marker{
	name = "---Merge Conflict Marker---";
	
	desc = "A best-effort merge was performed. You must resolve this conflict yourself (manually) and remove this object once complete."
	},
/obj/effect/decal/cleanable/cobweb,
/obj/effect/spawner/random/decoration/glowstick{
	pixel_x = 10;
	pixel_y = 9
	},
/obj/item/flashlight/lantern/on{
	pixel_x = -10;
	pixel_y = 5
	},
/obj/effect/gibspawner/human/bodypartless,
/turf/open/misc/dirt/jungle/dark,
/area/misc/condo)
"lQ" = (
/obj/structure/flora/rock/pile,
/obj/structure/flora/rock/pile/jungle/style_2,
/turf/open/misc/dirt/jungle/dark,
/area/misc/condo)
"nw" = (
/obj/item/flashlight/lantern/on{
	pixel_x = 9;
	pixel_y = 9
	},
/turf/open/misc/dirt/jungle/dark,
/area/misc/condo)
"nS" = (
/obj/effect/decal/cleanable/dirt/dust{
	pixel_x = 2;
	pixel_y = -1
	},
/obj/effect/decal/remains/human{
	pixel_x = -12;
	pixel_y = 9
	},
/turf/open/floor/wood/large,
/area/misc/condo)
"oP" = (
/obj/structure/flora/grass/jungle/a/style_4{
	pixel_x = 23;
	pixel_y = 0
	},
/turf/open/misc/dirt/jungle/dark,
/area/misc/condo)
"oQ" = (
/obj/effect/decal/cleanable/rubble,
/obj/structure/wall_torch/spawns_lit/directional/west,
/turf/open/misc/dirt/jungle/dark,
/area/misc/condo)
"ry" = (
/turf/closed/mineral/random/asteroid/rockplanet/labor,
/area/misc/condo)
"rZ" = (
/obj/effect/supplypod_rubble,
/turf/open/misc/dirt/jungle/dark,
/area/misc/condo)
"sr" = (
/obj/effect/decal/cleanable/dirt/dust,
/obj/machinery/door/morgue,
/turf/open/floor/wood/large,
/area/misc/condo)
"sZ" = (
/obj/effect/decal/cleanable/rubble,
/turf/open/misc/dirt/jungle/dark,
/area/misc/condo)
"wg" = (
/obj/effect/decal/cleanable/blood/old,
/obj/effect/decal/cleanable/dirt/dust,
/turf/open/floor/wood/large,
/area/misc/condo)
"yg" = (
/obj/machinery/room_controller/directional/north{
	layer = 3.5
	},
/turf/open/misc/dirt/jungle/dark,
/area/misc/condo)
"yX" = (
/obj/effect/decal/cleanable/cobweb/cobweb2,
/obj/machinery/portable_atmospherics/scrubber,
/turf/open/misc/dirt/jungle/dark,
/area/misc/condo)
"AH" = (
/obj/structure/mineral_door/wood,
/obj/structure/barricade/wooden/crude,
/turf/open/misc/dirt/jungle/dark,
/area/misc/condo)
"Bt" = (
/obj/structure/flora/rock/style_4,
/turf/open/misc/dirt/jungle/dark,
/area/misc/condo)
"BJ" = (
/obj/structure/table/wood,
/obj/effect/spawner/random/food_or_drink/booze{
	pixel_x = -8;
	pixel_y = 6
	},
/obj/effect/spawner/random/food_or_drink/dinner{
	pixel_x = 4;
	pixel_y = 5
	},
/turf/open/floor/wood/large{
	invisibility = 1
	},
/area/misc/condo)
"Cb" = (
/turf/closed/mineral/random/asteroid/rockplanet/labor{
	pixel_x = 0;
	pixel_y = 0
	},
/area/misc/condo)
"CA" = (
/obj/structure/table/wood,
/turf/open/floor/wood/large{
	invisibility = 1
	},
/area/misc/condo)
"DU" = (
/obj/structure/flora/rock,
/turf/open/water{
	planetary_atmos = 0
	},
/area/misc/condo)
"Ec" = (
/obj/structure/flora/grass/jungle/a/style_4{
	pixel_x = 3;
	pixel_y = 39
	},
/turf/open/misc/dirt/jungle/dark,
/area/misc/condo)
"EP" = (
/obj/structure/closet/crate,
/obj/item/flashlight{
	pixel_x = 3;
	pixel_y = -1
	},
/obj/item/flashlight{
	pixel_x = -5;
	pixel_y = -4
	},
/obj/item/flashlight/flare,
/obj/item/flashlight/flare{
	pixel_x = 2;
	pixel_y = 3
	},
/obj/item/flashlight/flare{
	pixel_x = 0;
	pixel_y = 5
	},
/obj/item/clothing/head/utility/hardhat/white{
	pixel_x = -2;
	pixel_y = 0
	},
/obj/item/clothing/head/utility/hardhat/white{
	pixel_x = -8;
	pixel_y = 1
	},
/turf/open/misc/dirt/jungle/dark,
/area/misc/condo)
"EU" = (
/obj/effect/decal/cleanable/rubble,
/obj/structure/spacevine,
/turf/open/misc/dirt/jungle/dark,
/area/misc/condo)
"Fa" = (
/obj/effect/decal/cleanable/blood/old{
	pixel_x = -2;
	pixel_y = -1
	},
/obj/effect/decal/remains/human{
	pixel_x = -4;
	pixel_y = 6
	},
/turf/open/misc/dirt/jungle/dark,
/area/misc/condo)
"FY" = (
/turf/open/misc/grass/jungle,
/area/misc/condo)
"Gn" = (
/obj/structure/table/wood/shuttle_bar,
/obj/item/flashlight/flare/candle/infinite{
	pixel_x = 8;
	pixel_y = 9
	},
/obj/effect/decal/cleanable/dirt/dust,
/obj/effect/decal/cleanable/dirt/dust,
/turf/open/floor/wood,
/area/misc/condo)
"Gx" = (
/obj/structure/spacevine,
/turf/open/water{
	planetary_atmos = 0
	},
/area/misc/condo)
"Hc" = (
/turf/closed/indestructible/hoteldoor/fakedoor,
/area/misc/condo)
"HH" = (
/obj/item/crowbar,
/turf/open/misc/dirt/jungle/dark,
/area/misc/condo)
"Ir" = (
/obj/structure/dresser,
/obj/effect/decal/cleanable/dirt/dust,
/turf/open/floor/wood/large,
/area/misc/condo)
"Jb" = (
/obj/structure/flora/bush/stalky/style_2,
/turf/open/water{
	planetary_atmos = 0
	},
/area/misc/condo)
"Jc" = (
/obj/structure/flora/rock/pile/jungle/large,
/turf/open/misc/grass/jungle,
/area/misc/condo)
"JN" = (
/obj/structure/flora/rock/icy/style_3,
/obj/effect/decal/cleanable/cobweb/cobweb2,
/obj/effect/heretic_rune,
/turf/open/misc/dirt/jungle/dark,
/area/misc/condo)
"Kl" = (
/obj/item/forging/incomplete/pickaxe{
	pixel_x = -12;
	pixel_y = -1
	},
/turf/open/misc/dirt/jungle/dark,
/area/misc/condo)
"Mg" = (
/obj/structure/flora/ocean/glowweed{
	pixel_x = 15;
	pixel_y = 12
	},
/turf/open/misc/dirt/jungle/dark,
/area/misc/condo)
"Mh" = (
/obj/structure/spacevine,
/turf/closed/mineral/random/asteroid/rockplanet/labor,
/area/misc/condo)
"Mo" = (
/obj/effect/decal/cleanable/ash/large{
	pixel_x = -25;
	pixel_y = 12
	},
/obj/effect/decal/cleanable/dirt/dust,
/turf/open/floor/wood/large,
/area/misc/condo)
"Mu" = (
/turf/open/water{
	planetary_atmos = 0
	},
/area/misc/condo)
"MH" = (
/turf/open/misc/dirt/jungle/dark,
/area/misc/condo)
"Nd" = (
/obj/effect/decal/cleanable/dirt,
/obj/effect/decal/cleanable/dirt/dust,
/turf/open/floor/wood/large,
/area/misc/condo)
"PC" = (
/obj/effect/decal/cleanable/dirt/dust,
/obj/structure/table/wood/shuttle_bar,
/turf/open/floor/wood/large,
/area/misc/condo)
"RI" = (
/obj/effect/decal/remains/xeno,
/turf/open/misc/dirt/jungle/dark,
/area/misc/condo)
"Ud" = (
/turf/open/floor/wood/large{
	invisibility = 1
	},
/area/misc/condo)
"VW" = (
/obj/structure/closet/secure_closet/personal/cabinet,
/obj/item/hairbrush/tactical,
/obj/item/serviette_pack,
/obj/effect/decal/cleanable/dirt/dust,
/turf/open/floor/wood/large,
/area/misc/condo)
"XE" = (
/obj/structure/bed/maint,
/turf/open/misc/dirt/jungle/dark,
/area/misc/condo)
"YM" = (
/obj/structure/spacevine,
/turf/open/misc/dirt/jungle/dark,
/area/misc/condo)

(1,1,1) = {"
ry
ry
ry
ry
ry
ry
ry
ry
ry
ry
ry
ry
ry
ry
ry
"}
(2,1,1) = {"
ry
ry
Hc
ry
ry
ry
kr
MH
EP
oQ
ry
ry
ry
ry
ry
"}
(3,1,1) = {"
ry
ry
MH
MH
ry
ry
rZ
Kl
MH
MH
MH
XE
ry
ry
ry
"}
(4,1,1) = {"
ry
aX
yg
MH
sZ
ry
Cb
Cb
yX
nw
MH
MH
MH
BJ
ry
"}
(5,1,1) = {"
ry
ry
ry
sZ
sZ
Fa
Cb
Cb
Mh
Mh
YM
sZ
Ud
CA
ry
"}
(6,1,1) = {"
ry
ry
ry
bd
MH
MH
sZ
Mh
Mh
Mh
YM
ry
ry
ry
ry
"}
(7,1,1) = {"
ry
ry
ry
ry
av
MH
MH
MH
EU
YM
MH
MH
ry
ry
ry
"}
(8,1,1) = {"
ry
cw
ry
ry
sZ
MH
MH
MH
Mh
fO
MH
MH
Bt
ry
ry
"}
(9,1,1) = {"
ry
do
ry
ry
ry
Cb
JN
MH
ry
ry
RI
oP
MH
kb
ry
"}
(10,1,1) = {"
ry
sr
ry
ry
ry
Cb
ry
HH
ry
ry
ry
Mg
MH
Ec
ry
"}
(11,1,1) = {"
ry
do
do
do
Nd
do
AH
MH
ry
ry
ry
lQ
MH
MH
ry
"}
(12,1,1) = {"
ry
eg
nS
do
bQ
do
ry
ry
ry
ry
DU
Mu
Jc
FY
ry
"}
(13,1,1) = {"
ry
PC
Mo
do
wg
do
ry
ry
ry
Jb
Mu
Mu
Mu
hM
ry
"}
(14,1,1) = {"
ry
do
do
do
do
do
ry
Mh
Mh
Gx
Mu
Mu
Mu
Mu
ry
"}
(15,1,1) = {"
ry
co
Ir
jk
Gn
VW
ry
Mh
Gx
Gx
Gx
Mu
Mu
Mu
ry
"}
(16,1,1) = {"
ry
ry
ry
ry
ry
ry
ry
Mh
Mh
Mh
Mh
ry
ry
ry
ry
"}
