//MAP CONVERTED BY dmm2tgm.py THIS HEADER COMMENT PREVENTS RECONVERSION, DO NOT REMOVE
"ai" = (
/obj/effect/turf_decal/tile/yellow/half/contrasted{
	dir = 4
	},
/turf/open/floor/iron,
/area/misc/condo)
"bh" = (
/obj/structure/closet/firecloset,
/obj/effect/turf_decal/siding/yellow{
	dir = 4
	},
/obj/effect/turf_decal/siding/yellow{
	dir = 8
	},
/obj/machinery/light/small/directional/west,
/turf/open/floor/iron/smooth_large,
/area/misc/condo)
"bL" = (
/obj/structure/cable,
/obj/effect/turf_decal/stripes/line{
	dir = 5
	},
/turf/open/floor/engine,
/area/misc/condo)
"bP" = (
/obj/effect/turf_decal/stripes/line,
/obj/structure/sign/warning/electric_shock/directional/south,
/turf/open/floor/engine,
/area/misc/condo)
"ck" = (
/obj/effect/turf_decal/tile/yellow/half{
	dir = 1
	},
/obj/structure/chair/office{
	dir = 1;
	name = "grimy chair"
	},
/turf/open/floor/iron/smooth_half,
/area/misc/condo)
"dm" = (
/obj/effect/turf_decal/tile/yellow/half{
	dir = 4
	},
/turf/open/floor/iron/smooth_half{
	dir = 1
	},
/area/misc/condo)
"ej" = (
/obj/machinery/atmospherics/components/unary/vent_pump/on{
	dir = 4
	},
/obj/machinery/light/directional/east,
/turf/open/floor/engine,
/area/misc/condo)
"ff" = (
/obj/effect/spawner/structure/window/reinforced/plasma,
/turf/open/floor/plating,
/area/misc/condo)
"fQ" = (
/obj/effect/turf_decal/stripes/line{
	dir = 1
	},
/turf/open/floor/engine,
/area/misc/condo)
"gM" = (
/obj/machinery/power/smes,
/turf/open/floor/iron/smooth_large,
/area/misc/condo)
"hA" = (
/obj/effect/turf_decal/stripes/line{
	dir = 4
	},
/turf/open/floor/engine,
/area/misc/condo)
"hS" = (
/obj/effect/turf_decal/stripes/line{
	dir = 9
	},
/turf/open/floor/engine,
/area/misc/condo)
"iq" = (
/turf/open/floor/engine,
/area/misc/condo)
"iA" = (
/obj/machinery/door/airlock/engineering/glass,
/turf/open/floor/iron/dark,
/area/misc/condo)
"kv" = (
/obj/effect/turf_decal/tile/yellow/anticorner{
	dir = 8
	},
/turf/open/floor/iron/smooth_corner{
	dir = 4
	},
/area/misc/condo)
"le" = (
/obj/effect/turf_decal/siding/yellow/corner,
/obj/effect/turf_decal/siding/yellow/corner{
	dir = 1
	},
/obj/effect/turf_decal/siding/yellow/corner{
	dir = 4
	},
/obj/effect/turf_decal/siding/yellow/corner{
	dir = 8
	},
/turf/open/floor/iron/smooth_large,
/area/misc/condo)
"lP" = (
/obj/machinery/door/poddoor{
	id = "hiblert"
	},
/turf/open/floor/iron/dark,
/area/misc/condo)
"lZ" = (
/turf/open/floor/iron/showroomfloor,
/area/misc/condo)
"mb" = (
/obj/structure/reagent_dispensers/watertank{
	icon = 'modular_skyrat/modules/aesthetics/emitter/icons/emitter.dmi';
	icon_state = "emitter";
	anchored = 1
	},
/turf/open/floor/iron/dark,
/area/misc/condo)
"ml" = (
/obj/machinery/light/small/dim/directional/east,
/turf/open/floor/plating,
/area/misc/condo)
"nc" = (
/obj/structure/window/reinforced/plasma/spawner/directional/west,
/obj/machinery/atmospherics/components/unary/vent_scrubber/on{
	dir = 8
	},
/turf/open/floor/engine,
/area/misc/condo)
"nl" = (
/turf/open/floor/iron/dark,
/area/misc/condo)
"nC" = (
/obj/structure/table,
/turf/open/floor/iron/dark,
/area/misc/condo)
"oF" = (
/obj/effect/turf_decal/tile/yellow/anticorner{
	dir = 4
	},
/obj/structure/rack,
/turf/open/floor/iron/smooth_corner{
	dir = 8
	},
/area/misc/condo)
"pq" = (
/obj/structure/table,
/obj/structure/reagent_dispensers/servingdish{
	icon = 'icons/obj/machines/engine/supermatter.dmi';
	icon_state = "sm";
	name = "souper matter"
	},
/turf/open/floor/engine,
/area/misc/condo)
"pw" = (
/obj/structure/girder,
/turf/open/floor/iron/dark,
/area/misc/condo)
"pH" = (
/obj/structure/reagent_dispensers/watertank{
	icon = 'modular_skyrat/modules/aesthetics/emitter/icons/emitter.dmi';
	icon_state = "emitter"
	},
/turf/open/floor/plating,
/area/misc/condo)
"qj" = (
/obj/effect/turf_decal/tile/yellow/half,
/turf/open/floor/iron/smooth_half,
/area/misc/condo)
"qm" = (
/obj/effect/turf_decal/tile/yellow/half/contrasted{
	dir = 8
	},
/turf/open/floor/iron,
/area/misc/condo)
"rc" = (
/obj/effect/turf_decal/siding/yellow,
/obj/effect/turf_decal/siding/yellow{
	dir = 1
	},
/turf/open/floor/iron/smooth_large,
/area/misc/condo)
"sS" = (
/obj/machinery/door/poddoor{
	id = "hiblert"
	},
/turf/open/floor/plating,
/area/misc/condo)
"tK" = (
/obj/effect/turf_decal/tile/yellow/anticorner/contrasted{
	dir = 8
	},
/turf/open/floor/iron,
/area/misc/condo)
"uy" = (
/obj/structure/chair/sofa/bench/right,
/obj/effect/turf_decal/tile/yellow/anticorner/contrasted{
	dir = 1
	},
/turf/open/floor/iron,
/area/misc/condo)
"uM" = (
/obj/structure/closet/secure_closet/personal{
	icon_state = "eng";
	icon_door = "eng_weld";
	name = "engineering closet"
	},
/obj/effect/turf_decal/siding/yellow{
	dir = 4
	},
/obj/effect/turf_decal/siding/yellow{
	dir = 8
	},
/obj/machinery/light/small/directional/west,
/turf/open/floor/iron/smooth_large,
/area/misc/condo)
"vi" = (
/obj/effect/turf_decal/stripes/line{
	dir = 4
	},
/obj/effect/turf_decal/stripes/corner{
	dir = 8
	},
/turf/open/floor/engine,
/area/misc/condo)
"vM" = (
/obj/structure/closet/crate,
/turf/open/floor/plating,
/area/misc/condo)
"vV" = (
/obj/machinery/portable_atmospherics/canister,
/obj/effect/turf_decal/bot,
/turf/open/floor/engine,
/area/misc/condo)
"wN" = (
/obj/effect/turf_decal/tile/yellow/half/contrasted{
	dir = 1
	},
/obj/effect/turf_decal/tile/dark/half,
/obj/structure/closet/secure_closet/personal{
	icon_state = "eng";
	icon_door = "eng_weld";
	name = "engineering closet"
	},
/turf/open/floor/iron,
/area/misc/condo)
"xu" = (
/obj/effect/turf_decal/tile/yellow/half{
	dir = 1
	},
/obj/structure/rack,
/obj/item/storage/toolbox/mechanical,
/turf/open/floor/iron/smooth_half,
/area/misc/condo)
"ys" = (
/obj/machinery/light/directional/west,
/obj/machinery/vending/tool{
	contraband = list();
	premium = list();
	products = list(/obj/item/clothing/accessory/clown_enjoyer_pin = 1)
	},
/turf/open/floor/iron/dark,
/area/misc/condo)
"yC" = (
/obj/machinery/vending/engivend{
	contraband = list();
	premium = list();
	products = list(/obj/item/clothing/accessory/clown_enjoyer_pin = 1)
	},
/turf/open/floor/iron/dark,
/area/misc/condo)
"zs" = (
/obj/machinery/vending/wardrobe/engi_wardrobe/ghost_cafe{
	zubbers_products = null;
	vend_reply = "Clown.";
	products = list(/obj/item/clothing/accessory/clown_enjoyer_pin = 1)
	},
/turf/open/floor/iron/dark,
/area/misc/condo)
"AA" = (
/obj/effect/turf_decal/stripes/line{
	dir = 8
	},
/obj/structure/sign/warning/electric_shock/directional/west,
/turf/open/floor/engine,
/area/misc/condo)
"AC" = (
/obj/machinery/shower/directional/west,
/obj/structure/fluff/shower_drain,
/turf/open/floor/iron/showroomfloor,
/area/misc/condo)
"Cv" = (
/obj/structure/rack,
/obj/item/reagent_containers/cup/bowl,
/obj/item/reagent_containers/cup/bowl,
/obj/item/reagent_containers/cup/bowl,
/obj/item/reagent_containers/cup/bowl,
/obj/item/reagent_containers/cup/bowl,
/obj/effect/turf_decal/bot,
/turf/open/floor/engine,
/area/misc/condo)
"Cy" = (
/obj/machinery/shower/directional/east,
/obj/structure/fluff/shower_drain,
/turf/open/floor/iron/showroomfloor,
/area/misc/condo)
"CB" = (
/obj/effect/turf_decal/tile/yellow{
	dir = 1
	},
/turf/open/floor/iron/smooth_corner{
	dir = 1
	},
/area/misc/condo)
"Dj" = (
/turf/open/floor/iron/smooth_large,
/area/misc/condo)
"Dq" = (
/obj/structure/chair/office{
	dir = 8
	},
/obj/effect/turf_decal/tile/yellow/half{
	dir = 8
	},
/turf/open/floor/iron/smooth_half{
	dir = 1
	},
/area/misc/condo)
"Dx" = (
/obj/machinery/door/airlock/engineering/glass,
/turf/open/floor/engine,
/area/misc/condo)
"Eo" = (
/turf/closed/indestructible/hoteldoor/fakedoor,
/area/misc/condo)
"EO" = (
/obj/machinery/door/poddoor/preopen{
	id = "Engineering";
	name = "Engineering Blast Door"
	},
/obj/effect/spawner/structure/window/reinforced,
/turf/open/floor/plating,
/area/misc/condo)
"Fb" = (
/obj/effect/turf_decal/stripes/line{
	dir = 5
	},
/turf/open/floor/engine,
/area/misc/condo)
"FD" = (
/obj/machinery/power/energy_accumulator/grounding_rod/anchored,
/turf/open/floor/engine,
/area/misc/condo)
"FW" = (
/turf/open/floor/plating,
/area/misc/condo)
"Gl" = (
/turf/open/floor/iron,
/area/misc/condo)
"GN" = (
/obj/machinery/portable_atmospherics/canister,
/obj/effect/turf_decal/bot,
/obj/structure/sign/warning/fire/directional/south,
/turf/open/floor/engine,
/area/misc/condo)
"GZ" = (
/obj/machinery/atmospherics/components/unary/thermomachine/freezer{
	dir = 8
	},
/obj/effect/turf_decal/bot,
/turf/open/floor/engine,
/area/misc/condo)
"Hz" = (
/turf/closed/indestructible/reinforced,
/area/misc/condo)
"HN" = (
/obj/structure/chair/sofa/bench/left,
/obj/effect/turf_decal/tile/yellow/anticorner/contrasted{
	dir = 4
	},
/turf/open/floor/iron,
/area/misc/condo)
"HW" = (
/obj/effect/turf_decal/stripes/line{
	dir = 8
	},
/turf/open/floor/engine,
/area/misc/condo)
"Ih" = (
/obj/effect/turf_decal/tile/yellow/half{
	dir = 1
	},
/turf/open/floor/iron/smooth_half,
/area/misc/condo)
"IU" = (
/obj/machinery/door/airlock/engineering,
/turf/open/floor/iron,
/area/misc/condo)
"JT" = (
/obj/effect/turf_decal/stripes/corner,
/obj/effect/turf_decal/stripes/corner{
	dir = 1
	},
/turf/open/floor/engine,
/area/misc/condo)
"KO" = (
/obj/effect/turf_decal/tile/yellow/anticorner/contrasted,
/turf/open/floor/iron,
/area/misc/condo)
"KR" = (
/obj/machinery/computer{
	dir = 1
	},
/obj/effect/turf_decal/tile/yellow/anticorner{
	dir = 8
	},
/turf/open/floor/iron/smooth_corner{
	dir = 4
	},
/area/misc/condo)
"Lj" = (
/obj/machinery/suit_storage_unit,
/turf/open/floor/iron/smooth_large,
/area/misc/condo)
"Lt" = (
/obj/machinery/light/directional/north,
/obj/structure/cable,
/turf/open/floor/plating,
/area/misc/condo)
"Nt" = (
/obj/machinery/atmospherics/components/unary/vent_pump/on{
	dir = 4
	},
/turf/open/floor/engine,
/area/misc/condo)
"Oh" = (
/obj/machinery/door/airlock/bathroom,
/turf/open/floor/iron,
/area/misc/condo)
"OA" = (
/obj/machinery/door/poddoor{
	id = "hiblert"
	},
/turf/open/floor/iron,
/area/misc/condo)
"OG" = (
/obj/machinery/power/shieldwallgen,
/turf/open/floor/plating,
/area/misc/condo)
"OM" = (
/obj/structure/reagent_dispensers/fueltank,
/obj/effect/turf_decal/tile/yellow/anticorner,
/turf/open/floor/iron/smooth_corner{
	dir = 1
	},
/area/misc/condo)
"ON" = (
/obj/machinery/door/poddoor/preopen{
	id = "hiblert"
	},
/turf/open/floor/plating,
/area/misc/condo)
"PS" = (
/obj/machinery/light/directional/north,
/obj/structure/sign/warning/fire/directional/north,
/obj/effect/turf_decal/stripes/line{
	dir = 9
	},
/turf/open/floor/engine,
/area/misc/condo)
"Qq" = (
/obj/machinery/atmospherics/components/unary/thermomachine/freezer{
	dir = 8
	},
/obj/effect/turf_decal/bot,
/obj/structure/sign/warning/fire/directional/north,
/turf/open/floor/engine,
/area/misc/condo)
"QF" = (
/obj/effect/turf_decal/stripes/line{
	dir = 8
	},
/obj/effect/turf_decal/stripes/corner{
	dir = 4
	},
/turf/open/floor/engine,
/area/misc/condo)
"Rd" = (
/obj/effect/turf_decal/stripes/line{
	dir = 10
	},
/turf/open/floor/engine,
/area/misc/condo)
"RE" = (
/obj/effect/turf_decal/stripes/line{
	dir = 6
	},
/turf/open/floor/engine,
/area/misc/condo)
"RO" = (
/obj/structure/cable,
/turf/open/floor/plating,
/area/misc/condo)
"RS" = (
/obj/structure/table/reinforced,
/obj/item/storage/toolbox/mechanical,
/obj/item/analyzer,
/obj/item/pipe_dispenser{
	anchored = 1
	},
/obj/item/flashlight,
/turf/open/floor/engine,
/area/misc/condo)
"RW" = (
/obj/machinery/computer,
/turf/open/floor/iron/smooth_large,
/area/misc/condo)
"RX" = (
/obj/effect/turf_decal/stripes/line,
/turf/open/floor/engine,
/area/misc/condo)
"Sn" = (
/obj/machinery/door/airlock/engineering/glass,
/turf/open/floor/iron/smooth_large,
/area/misc/condo)
"SD" = (
/obj/effect/turf_decal/tile/yellow/half/contrasted,
/obj/effect/turf_decal/tile/dark/half{
	dir = 1
	},
/obj/machinery/light/directional/east,
/obj/structure/closet/secure_closet/personal{
	icon_state = "eng";
	icon_door = "eng_weld";
	name = "engineering closet"
	},
/turf/open/floor/iron,
/area/misc/condo)
"SW" = (
/obj/effect/turf_decal/tile/yellow/anticorner{
	dir = 1
	},
/turf/open/floor/iron/smooth_corner,
/area/misc/condo)
"Th" = (
/obj/structure/table/reinforced,
/obj/item/tank/internals/emergency_oxygen/engi{
	pixel_x = 5;
	anchored = 1
	},
/obj/item/clothing/gloves/color/black,
/obj/item/clothing/glasses/meson/engine{
	anchored = 1
	},
/turf/open/floor/engine,
/area/misc/condo)
"TU" = (
/obj/effect/turf_decal/tile/yellow/half{
	dir = 8
	},
/obj/machinery/light/directional/west,
/obj/machinery/room_controller/directional/west,
/turf/open/floor/iron/smooth_half{
	dir = 1
	},
/area/misc/condo)
"US" = (
/obj/machinery/light/small/directional/east,
/turf/open/floor/iron/showroomfloor,
/area/misc/condo)
"UY" = (
/obj/effect/turf_decal/tile/yellow/anticorner{
	dir = 1
	},
/obj/machinery/light/directional/west,
/obj/structure/chair/office{
	dir = 1;
	name = "grimy chair"
	},
/turf/open/floor/iron/smooth_corner,
/area/misc/condo)
"VQ" = (
/obj/effect/turf_decal/stripes/line{
	dir = 1
	},
/obj/structure/sign/warning/directional/north,
/turf/open/floor/engine,
/area/misc/condo)
"Xj" = (
/obj/effect/turf_decal/tile/yellow/half/contrasted,
/obj/effect/turf_decal/tile/dark/half{
	dir = 1
	},
/obj/structure/closet/secure_closet/personal{
	icon_state = "eng";
	icon_door = "eng_weld";
	name = "engineering closet"
	},
/turf/open/floor/iron,
/area/misc/condo)
"Xo" = (
/obj/effect/turf_decal/tile/yellow/half{
	dir = 4
	},
/obj/structure/sign/warning/directional/east,
/turf/open/floor/iron/smooth_half{
	dir = 1
	},
/area/misc/condo)
"Yd" = (
/obj/machinery/light/directional/south,
/obj/effect/turf_decal/stripes/line{
	dir = 10
	},
/turf/open/floor/engine,
/area/misc/condo)
"Zm" = (
/obj/effect/spawner/structure/window/reinforced/plasma,
/obj/structure/cable,
/turf/open/floor/plating,
/area/misc/condo)
"Zp" = (
/obj/machinery/power/energy_accumulator/tesla_coil/anchored,
/turf/open/floor/engine,
/area/misc/condo)

(1,1,1) = {"
Hz
Hz
Hz
Hz
Hz
Hz
Hz
Hz
Hz
Hz
Hz
Hz
Hz
Hz
Hz
"}
(2,1,1) = {"
Hz
zs
yC
ys
Hz
Eo
Hz
OA
lP
Hz
RW
UY
kv
gM
Hz
"}
(3,1,1) = {"
Hz
uy
qm
tK
Hz
SW
TU
Dq
KR
EO
RW
ck
qj
gM
Hz
"}
(4,1,1) = {"
Hz
HN
Gl
KO
IU
Ih
Dj
Dj
qj
Sn
SW
CB
qj
gM
Hz
"}
(5,1,1) = {"
Hz
Xj
Gl
wN
Hz
oF
dm
Xo
OM
EO
xu
Dj
qj
Lj
Hz
"}
(6,1,1) = {"
Hz
Xj
Gl
wN
Hz
Hz
Sn
Hz
Hz
Hz
sS
sS
ON
Hz
Hz
"}
(7,1,1) = {"
Hz
SD
ai
wN
Hz
uM
le
bh
Hz
pH
FW
FW
FW
OG
Hz
"}
(8,1,1) = {"
Hz
Hz
Oh
Hz
Hz
AC
rc
AC
Hz
pH
FW
ml
vM
OG
Hz
"}
(9,1,1) = {"
Hz
Cy
lZ
Cy
Hz
Hz
Sn
Hz
Hz
Hz
Hz
Hz
Hz
Hz
Hz
"}
(10,1,1) = {"
Hz
AC
US
AC
Hz
Cv
hS
AA
HW
HW
HW
Rd
RS
Th
Hz
"}
(11,1,1) = {"
Hz
Hz
Hz
Hz
Hz
PS
JT
hA
hA
hA
hA
vi
QF
Yd
Hz
"}
(12,1,1) = {"
Hz
nC
nl
nl
iA
fQ
RX
Hz
Zp
FD
Zp
Hz
fQ
RX
Hz
"}
(13,1,1) = {"
Hz
Lt
RO
RO
Zm
fQ
bP
Hz
nc
nc
nc
Hz
VQ
RX
Hz
"}
(14,1,1) = {"
Hz
pw
mb
nl
Zm
bL
RE
ff
iq
pq
iq
Dx
Fb
RE
Hz
"}
(15,1,1) = {"
Hz
RO
RO
RO
Zm
vV
GN
Hz
Nt
ej
Nt
Hz
Qq
GZ
Hz
"}
(16,1,1) = {"
Hz
Hz
Hz
Hz
Hz
Hz
Hz
Hz
Hz
Hz
Hz
Hz
Hz
Hz
Hz
"}
