//MAP CONVERTED BY dmm2tgm.py THIS HEADER COMMENT PREVENTS RECONVERSION, DO NOT REMOVE
"aL" = (
/obj/effect/turf_decal/siding/wood,
/turf/open/floor/wood/large,
/area/misc/condo)
"bg" = (
/obj/structure/chair/wood/wings,
/turf/open/floor/carpet/black,
/area/misc/condo)
"bH" = (
/obj/effect/turf_decal/siding/wood{
	dir = 9
	},
/obj/item/kirbyplants/organic/plant21,
/turf/open/floor/wood/parquet,
/area/misc/condo)
"bT" = (
/obj/structure/chair/wood/wings{
	dir = 1
	},
/turf/open/floor/carpet/black,
/area/misc/condo)
"cW" = (
/obj/structure/curtain/cloth/fancy,
/turf/open/floor/carpet/black,
/area/misc/condo)
"dj" = (
/obj/structure/table/reinforced,
/turf/open/floor/wood/large,
/area/misc/condo)
"dI" = (
/obj/machinery/computer/slot_machine,
/turf/open/floor/carpet/black,
/area/misc/condo)
"fi" = (
/obj/effect/turf_decal/siding/wood{
	dir = 1
	},
/turf/open/floor/wood/parquet,
/area/misc/condo)
"fo" = (
/obj/effect/turf_decal/siding/wood{
	dir = 10
	},
/obj/effect/turf_decal/siding/wood/corner{
	dir = 4
	},
/obj/item/kirbyplants/organic/plant21,
/turf/open/floor/wood/large,
/area/misc/condo)
"gm" = (
/turf/closed/indestructible/hoteldoor/fakedoor,
/area/misc/condo)
"hy" = (
/obj/structure/chair/comfy/brown{
	dir = 4
	},
/turf/open/floor/wood/large,
/area/misc/condo)
"hJ" = (
/obj/structure/chair/comfy/brown{
	dir = 8
	},
/turf/open/floor/carpet/green,
/area/misc/condo)
"hN" = (
/obj/structure/table/wood,
/turf/open/floor/carpet/black,
/area/misc/condo)
"iq" = (
/obj/effect/spawner/random/entertainment/arcade{
	dir = 8
	},
/obj/machinery/light/directional/east,
/turf/open/floor/carpet/black,
/area/misc/condo)
"iw" = (
/obj/structure/reagent_dispensers/beerkeg,
/obj/machinery/light/small/dim/directional/west,
/turf/open/floor/wood/large,
/area/misc/condo)
"kb" = (
/obj/structure/closet/secure_closet/bar,
/turf/open/floor/wood/large,
/area/misc/condo)
"lY" = (
/obj/effect/turf_decal/tile/dark/opposingcorners,
/obj/structure/table/reinforced/rglass,
/obj/machinery/light/directional/east,
/obj/machinery/chem_dispenser/drinks/beer/fullupgrade{
	pixel_y = 7
	},
/turf/open/floor/wood/large,
/area/misc/condo)
"mH" = (
/obj/effect/turf_decal/siding/wood{
	dir = 4
	},
/turf/open/floor/wood/parquet,
/area/misc/condo)
"ne" = (
/obj/structure/chair/sofa/corp/left{
	dir = 4
	},
/obj/effect/turf_decal/siding/wood{
	dir = 8
	},
/turf/open/floor/wood/parquet,
/area/misc/condo)
"nh" = (
/obj/effect/turf_decal/siding/wood{
	dir = 1
	},
/obj/effect/turf_decal/siding/wood,
/turf/open/floor/wood/large,
/area/misc/condo)
"nG" = (
/obj/effect/turf_decal/siding/wood,
/obj/effect/turf_decal/siding/wood{
	dir = 1
	},
/obj/effect/turf_decal/siding/wood{
	dir = 1
	},
/turf/open/floor/wood/large,
/area/misc/condo)
"nH" = (
/turf/open/floor/carpet/black,
/area/misc/condo)
"of" = (
/obj/effect/turf_decal/siding/wood{
	dir = 4
	},
/obj/effect/turf_decal/siding/wood{
	dir = 8
	},
/turf/open/floor/wood/large,
/area/misc/condo)
"ot" = (
/obj/effect/turf_decal/siding/wood,
/obj/effect/turf_decal/siding/wood{
	dir = 1
	},
/turf/open/floor/wood/large,
/area/misc/condo)
"ps" = (
/obj/structure/table/wood/fancy/blue,
/obj/machinery/light/directional/south,
/turf/open/floor/wood/parquet,
/area/misc/condo)
"pz" = (
/obj/structure/table/reinforced,
/obj/structure/desk_bell{
	pixel_x = 5;
	pixel_y = 3
	},
/turf/open/floor/wood/large,
/area/misc/condo)
"pE" = (
/obj/structure/chair/sofa/middle/brown{
	dir = 2
	},
/turf/open/floor/carpet/black,
/area/misc/condo)
"ql" = (
/turf/closed/indestructible/rock,
/area/misc/condo)
"qm" = (
/obj/structure/chair/comfy/beige{
	dir = 4
	},
/turf/open/floor/carpet/black,
/area/misc/condo)
"qx" = (
/obj/effect/turf_decal/siding/wood/corner{
	dir = 1
	},
/turf/open/floor/wood/large,
/area/misc/condo)
"qz" = (
/obj/effect/turf_decal/siding/wood{
	dir = 4
	},
/obj/structure/table/wood/poker,
/obj/effect/spawner/random/entertainment/deck,
/turf/open/floor/wood/large,
/area/misc/condo)
"rW" = (
/obj/item/reagent_containers/cup/glass/drinkingglass/shotglass{
	pixel_y = 16;
	pixel_x = -10
	},
/obj/item/reagent_containers/cup/glass/bottle/small{
	pixel_y = 20;
	pixel_x = 9
	},
/obj/item/reagent_containers/cup/glass/drinkingglass{
	pixel_y = 18
	},
/obj/machinery/vending/boozeomat,
/turf/open/floor/wood/large,
/area/misc/condo)
"tu" = (
/obj/effect/turf_decal/siding/wood{
	dir = 1
	},
/obj/effect/turf_decal/siding/wood/corner{
	dir = 8
	},
/turf/open/floor/wood/large,
/area/misc/condo)
"tA" = (
/obj/structure/chair/stool/directional/east,
/obj/effect/turf_decal/siding/wood{
	dir = 5
	},
/turf/open/floor/wood/parquet,
/area/misc/condo)
"uB" = (
/obj/structure/chair/wood{
	dir = 1
	},
/turf/open/floor/carpet/black,
/area/misc/condo)
"vc" = (
/obj/structure/chair/sofa/middle/brown{
	dir = 1
	},
/turf/open/floor/carpet/black,
/area/misc/condo)
"vq" = (
/obj/structure/table/wood,
/obj/effect/decal/cleanable/cobweb,
/obj/item/toy/plush/skyrat/plushie_chiara{
	pixel_y = 5
	},
/turf/open/floor/wood/large,
/area/misc/condo)
"vt" = (
/obj/structure/chair/comfy/beige{
	dir = 8
	},
/turf/open/floor/carpet/black,
/area/misc/condo)
"vK" = (
/obj/effect/turf_decal/siding/wood{
	dir = 1
	},
/turf/open/floor/wood/large,
/area/misc/condo)
"xg" = (
/turf/closed/indestructible/wood,
/area/misc/condo)
"xv" = (
/obj/machinery/door/airlock/wood,
/turf/open/floor/wood/large,
/area/misc/condo)
"yJ" = (
/obj/effect/turf_decal/siding/wood{
	dir = 1
	},
/obj/structure/chair/comfy/brown{
	dir = 4
	},
/turf/open/floor/wood/large,
/area/misc/condo)
"yO" = (
/obj/structure/chair/sofa/left/brown{
	dir = 1
	},
/turf/open/floor/carpet/black,
/area/misc/condo)
"zM" = (
/turf/open/floor/wood/large,
/area/misc/condo)
"AD" = (
/obj/effect/turf_decal/siding/wood/corner{
	dir = 1
	},
/obj/item/kirbyplants/organic/plant21,
/turf/open/floor/wood/parquet,
/area/misc/condo)
"Bf" = (
/obj/structure/chair/sofa/right/brown,
/turf/open/floor/carpet/black,
/area/misc/condo)
"Bl" = (
/obj/effect/turf_decal/siding/wood{
	dir = 1
	},
/obj/effect/turf_decal/siding/wood{
	dir = 8
	},
/obj/effect/turf_decal/siding/wood/corner,
/turf/open/floor/wood/large,
/area/misc/condo)
"BN" = (
/obj/structure/chair/sofa/corp/left{
	dir = 8
	},
/obj/effect/turf_decal/siding/wood{
	dir = 4
	},
/turf/open/floor/wood/parquet,
/area/misc/condo)
"Cn" = (
/obj/effect/turf_decal/siding/wood{
	dir = 8
	},
/obj/effect/turf_decal/siding/wood/corner{
	dir = 4
	},
/turf/open/floor/wood/large,
/area/misc/condo)
"CE" = (
/obj/structure/table/wood/fancy/blue,
/turf/open/floor/wood/parquet,
/area/misc/condo)
"CF" = (
/obj/item/kirbyplants/organic/plant22,
/obj/machinery/light/small/directional/north,
/turf/open/floor/carpet/black,
/area/misc/condo)
"Da" = (
/obj/effect/turf_decal/siding/wood{
	dir = 5
	},
/obj/effect/turf_decal/siding/wood{
	dir = 8
	},
/obj/effect/turf_decal/siding/wood/corner{
	dir = 1
	},
/turf/open/floor/wood/large,
/area/misc/condo)
"Dn" = (
/obj/effect/turf_decal/siding/wood{
	dir = 1
	},
/obj/effect/turf_decal/siding/wood,
/obj/effect/turf_decal/siding/wood/corner,
/turf/open/floor/wood/large,
/area/misc/condo)
"Er" = (
/obj/effect/turf_decal/siding/wood{
	dir = 6
	},
/obj/effect/turf_decal/siding/wood/corner{
	dir = 1
	},
/turf/open/floor/wood/large,
/area/misc/condo)
"Eu" = (
/obj/effect/turf_decal/siding/wood{
	dir = 9
	},
/obj/machinery/room_controller/directional/west,
/turf/open/floor/wood/parquet,
/area/misc/condo)
"Ha" = (
/obj/structure/chair/wood,
/turf/open/floor/carpet/black,
/area/misc/condo)
"Hv" = (
/obj/effect/turf_decal/siding/wood,
/mob/living/basic/pet/fox/docile,
/obj/structure/bed/dogbed,
/turf/open/floor/wood/large,
/area/misc/condo)
"HS" = (
/obj/effect/turf_decal/siding/wood{
	dir = 6
	},
/obj/structure/table/wood/poker,
/obj/effect/spawner/random/entertainment/dice,
/obj/item/gun/ballistic/revolver/russian{
	pixel_y = 16
	},
/turf/open/floor/wood/large,
/area/misc/condo)
"Ih" = (
/obj/effect/turf_decal/siding/wood{
	dir = 8
	},
/obj/effect/turf_decal/siding/wood/corner,
/turf/open/floor/wood/large,
/area/misc/condo)
"Ja" = (
/obj/structure/chair/stool/bar/directional/west,
/obj/effect/turf_decal/siding/wood{
	dir = 8
	},
/turf/open/floor/wood/parquet,
/area/misc/condo)
"JE" = (
/obj/structure/table/wood/fancy/red,
/obj/machinery/light/directional/south,
/turf/open/floor/wood/parquet,
/area/misc/condo)
"Li" = (
/obj/structure/chair/sofa/middle/brown{
	dir = 8
	},
/turf/open/floor/carpet/black,
/area/misc/condo)
"Lz" = (
/obj/structure/chair/wood/wings{
	dir = 8
	},
/turf/open/floor/carpet/black,
/area/misc/condo)
"MK" = (
/obj/structure/table/wood/fancy/red,
/turf/open/floor/wood/parquet,
/area/misc/condo)
"Ne" = (
/obj/effect/turf_decal/siding/wood,
/obj/structure/chair/comfy/brown{
	dir = 4
	},
/turf/open/floor/wood/large,
/area/misc/condo)
"Ng" = (
/turf/open/floor/carpet/green,
/area/misc/condo)
"NF" = (
/obj/structure/table/wood,
/obj/item/storage/box/drinkingglasses,
/obj/item/toy/plush/skyrat/fox,
/turf/open/floor/wood/large,
/area/misc/condo)
"NI" = (
/obj/structure/chair/wood{
	dir = 4
	},
/turf/open/floor/carpet/black,
/area/misc/condo)
"Ol" = (
/obj/effect/turf_decal/siding/wood{
	dir = 4
	},
/obj/effect/turf_decal/siding/wood/corner{
	dir = 1
	},
/obj/structure/table/wood/poker,
/obj/item/storage/fancy/cigarettes/cigars,
/obj/item/storage/box/matches,
/turf/open/floor/wood/large,
/area/misc/condo)
"Pu" = (
/obj/structure/hedge,
/turf/open/floor/carpet/black,
/area/misc/condo)
"Qc" = (
/obj/machinery/light/small/directional/east,
/turf/open/floor/carpet/green,
/area/misc/condo)
"Qq" = (
/obj/structure/table/reinforced/rglass,
/obj/machinery/chem_dispenser/drinks/fullupgrade{
	pixel_y = 7
	},
/turf/open/floor/wood/large,
/area/misc/condo)
"Rd" = (
/obj/structure/table/wood/fancy/royalblack,
/turf/open/floor/carpet/red,
/area/misc/condo)
"Ry" = (
/obj/structure/chair/stool/directional/east,
/obj/effect/turf_decal/siding/wood{
	dir = 4
	},
/obj/effect/turf_decal/siding/wood,
/turf/open/floor/wood/parquet,
/area/misc/condo)
"RC" = (
/obj/effect/turf_decal/siding/wood{
	dir = 4
	},
/obj/effect/turf_decal/siding/wood{
	dir = 8
	},
/obj/machinery/light/directional/west,
/turf/open/floor/wood/large,
/area/misc/condo)
"Sg" = (
/turf/open/floor/carpet/red,
/area/misc/condo)
"SG" = (
/obj/structure/decorative/shelf/alcohol_assortment,
/turf/closed/indestructible/wood,
/area/misc/condo)
"SP" = (
/obj/structure/chair/sofa/corp/right{
	dir = 4
	},
/obj/effect/turf_decal/siding/wood{
	dir = 8
	},
/turf/open/floor/wood/parquet,
/area/misc/condo)
"SZ" = (
/obj/structure/chair/sofa/corner/brown{
	dir = 8
	},
/turf/open/floor/carpet/black,
/area/misc/condo)
"Tv" = (
/obj/item/kirbyplants/organic/plant22,
/obj/machinery/light/small/directional/south,
/turf/open/floor/carpet/black,
/area/misc/condo)
"TE" = (
/obj/effect/turf_decal/siding/wood{
	dir = 8
	},
/obj/effect/turf_decal/siding/wood{
	dir = 4
	},
/obj/machinery/light/directional/east,
/turf/open/floor/wood/large,
/area/misc/condo)
"TL" = (
/obj/structure/chair/wood{
	dir = 8
	},
/turf/open/floor/carpet/black,
/area/misc/condo)
"Ul" = (
/obj/machinery/reagentgrinder,
/obj/item/reagent_containers/cup/glass/shaker{
	pixel_y = 3;
	pixel_x = -10
	},
/obj/structure/table/reinforced/rglass,
/obj/machinery/light/directional/west,
/turf/open/floor/wood/large,
/area/misc/condo)
"Uo" = (
/obj/effect/turf_decal/siding/wood{
	dir = 1
	},
/obj/effect/turf_decal/siding/wood,
/obj/effect/turf_decal/siding/wood/corner{
	dir = 8
	},
/turf/open/floor/wood/large,
/area/misc/condo)
"Va" = (
/obj/effect/turf_decal/siding/wood{
	dir = 1
	},
/obj/machinery/barsign/all_access/directional/north,
/turf/open/floor/wood/parquet,
/area/misc/condo)
"Vf" = (
/obj/structure/table/reinforced,
/obj/item/storage/box/drinkingglasses,
/turf/open/floor/wood/large,
/area/misc/condo)
"Vu" = (
/obj/machinery/vending/wardrobe/bar_wardrobe/ghost_cafe{
	products = list(/obj/item/clothing/glasses/sunglasses/reagent = 1, /obj/item/clothing/accessory/waistcoat = 2, /obj/item/clothing/head/hats/tophat = 2, /obj/item/clothing/head/soft/black = 2, /obj/item/clothing/neck/petcollar = 1, /obj/item/clothing/neck/bowtie = 2, /obj/item/clothing/under/costume/buttondown/slacks/service = 2, /obj/item/clothing/under/costume/buttondown/skirt/service = 2, /obj/item/clothing/under/rank/civilian/purple_bartender = 2, /obj/item/clothing/suit/toggle/lawyer/greyscale = 1,  /obj/item/clothing/shoes/sneakers/black = 2, /obj/item/storage/bag/money = 2, /obj/item/storage/dice/hazard = 1, /obj/item/rag = 2)
	},
/turf/closed/indestructible/wood,
/area/misc/condo)
"Vv" = (
/obj/effect/turf_decal/siding/wood{
	dir = 8
	},
/obj/effect/turf_decal/siding/wood{
	dir = 4
	},
/turf/open/floor/wood/large,
/area/misc/condo)
"VE" = (
/obj/effect/turf_decal/siding/wood{
	dir = 9
	},
/obj/effect/turf_decal/siding/wood{
	dir = 4
	},
/obj/effect/turf_decal/siding/wood/corner{
	dir = 4
	},
/turf/open/floor/wood/large,
/area/misc/condo)
"YK" = (
/obj/structure/chair/stool/bar/directional/north,
/obj/effect/turf_decal/siding/wood{
	dir = 1
	},
/turf/open/floor/wood/parquet,
/area/misc/condo)
"YT" = (
/obj/structure/chair/sofa/corp/right{
	dir = 8
	},
/obj/effect/turf_decal/siding/wood{
	dir = 4
	},
/turf/open/floor/wood/parquet,
/area/misc/condo)
"Zk" = (
/obj/structure/decorative/shelf/alcohol,
/turf/closed/indestructible/wood,
/area/misc/condo)
"ZG" = (
/obj/structure/chair/sofa/corner/brown,
/turf/open/floor/carpet/black,
/area/misc/condo)
"ZQ" = (
/obj/structure/hedge,
/obj/machinery/light/small/directional/west,
/turf/open/floor/carpet/black,
/area/misc/condo)
"ZX" = (
/obj/structure/hedge,
/obj/machinery/light/small/directional/east,
/turf/open/floor/carpet/black,
/area/misc/condo)

(1,1,1) = {"
xg
xg
xg
xg
xg
xg
xg
gm
xg
xg
xg
xg
xg
ql
ql
"}
(2,1,1) = {"
xg
vq
kb
iw
zM
xv
Eu
Bl
of
RC
of
fo
xg
xg
xg
"}
(3,1,1) = {"
xg
NF
zM
zM
zM
xg
Va
ot
nH
NI
nH
nh
ne
SP
xg
"}
(4,1,1) = {"
xg
Vu
xg
xg
xv
xg
fi
ot
bg
hN
uB
nh
MK
JE
xg
"}
(5,1,1) = {"
ql
ql
Zk
Ul
zM
dj
YK
ot
nH
TL
nH
Dn
YT
BN
xg
"}
(6,1,1) = {"
ql
ql
SG
Qq
zM
dj
YK
nG
nH
nH
nH
vK
aL
Pu
xg
"}
(7,1,1) = {"
ql
ql
Zk
rW
zM
dj
YK
ot
nH
NI
nH
vK
aL
Pu
xg
"}
(8,1,1) = {"
ql
ql
SG
lY
zM
dj
YK
ot
Ha
hN
bT
Uo
ne
SP
xg
"}
(9,1,1) = {"
ql
ql
xg
xg
Vf
pz
YK
ot
nH
Lz
nH
nh
CE
ps
xg
"}
(10,1,1) = {"
xg
xg
xg
bH
Ja
Ja
AD
tu
Ih
TE
Vv
Er
YT
BN
xg
"}
(11,1,1) = {"
xg
ZQ
qm
Da
of
of
Cn
qx
Hv
xg
xg
cW
cW
xg
xg
"}
(12,1,1) = {"
xg
Pu
nH
nH
nH
nH
yJ
hy
Ne
xg
CF
Sg
Sg
Tv
xg
"}
(13,1,1) = {"
xg
ZX
vt
VE
of
of
Ol
qz
HS
xg
Bf
Rd
Rd
yO
xg
"}
(14,1,1) = {"
xg
xg
xg
tA
mH
Ry
Ng
hJ
Qc
xg
pE
Rd
Rd
vc
xg
"}
(15,1,1) = {"
ql
ql
xg
dI
iq
dI
xg
xg
xg
xg
ZG
Li
Li
SZ
xg
"}
(16,1,1) = {"
ql
ql
xg
xg
xg
xg
xg
ql
ql
xg
xg
xg
xg
xg
xg
"}
