//MAP CONVERTED BY dmm2tgm.py THIS HEADER COMMENT PREVENTS RECONVERSION, DO NOT REMOVE
"bv" = (
/obj/structure/flora/bush/fullgrass/style_random,
/turf/open/floor/grass,
/area/misc/condo)
"cg" = (
/obj/structure/flora/bush/fullgrass/style_random,
/obj/structure/flora/bush/flowers_pp/style_random,
/turf/open/floor/grass,
/area/misc/condo)
"di" = (
/obj/effect/turf_decal/weather/dirt{
	dir = 4
	},
/obj/structure/flora/rock/style_random,
/turf/open/floor/grass,
/area/misc/condo)
"ed" = (
/obj/effect/turf_decal/weather/dirt,
/turf/open/water,
/area/misc/condo)
"el" = (
/obj/structure/flora/bush/flowers_yw/style_random,
/obj/effect/turf_decal/weather/dirt{
	dir = 1
	},
/turf/open/floor/grass,
/area/misc/condo)
"fi" = (
/turf/open/floor/grass,
/area/misc/condo)
"gw" = (
/obj/structure/chair/stool/directional/north,
/turf/open/misc/dirt/station,
/area/misc/condo)
"gO" = (
/obj/effect/turf_decal/weather/dirt{
	dir = 5
	},
/obj/structure/flora/bush/fullgrass/style_random,
/turf/open/floor/grass,
/area/misc/condo)
"hz" = (
/obj/structure/flora/rock/pile/jungle/style_random,
/turf/open/misc/dirt/station,
/area/misc/condo)
"hU" = (
/obj/structure/chair/stool/directional/west,
/turf/open/misc/dirt/station,
/area/misc/condo)
"ii" = (
/obj/structure/flora/bush/jungle/c/style_random,
/obj/effect/turf_decal/weather/dirt,
/turf/open/floor/grass,
/area/misc/condo)
"iA" = (
/obj/structure/flora/rock/style_random,
/obj/structure/flora/bush/jungle/c/style_random,
/obj/effect/turf_decal/weather/dirt,
/turf/open/floor/grass,
/area/misc/condo)
"iU" = (
/turf/closed/indestructible/rock,
/area/misc/condo)
"iW" = (
/obj/structure/flora/bush/jungle/b/style_random,
/turf/open/floor/grass,
/area/misc/condo)
"jF" = (
/obj/effect/turf_decal/weather/dirt{
	dir = 6
	},
/turf/open/floor/grass,
/area/misc/condo)
"kv" = (
/obj/effect/turf_decal/weather/dirt,
/turf/open/floor/grass,
/area/misc/condo)
"kz" = (
/obj/effect/light_emitter/fake_outdoors,
/turf/open/misc/dirt/station,
/area/misc/condo)
"kG" = (
/obj/structure/flora/bush/large/style_random,
/obj/effect/turf_decal/weather/dirt{
	dir = 10
	},
/turf/open/floor/grass,
/area/misc/condo)
"kI" = (
/obj/structure/flora/bush/flowers_br/style_random,
/turf/open/floor/grass,
/area/misc/condo)
"lp" = (
/obj/effect/turf_decal/weather/dirt{
	dir = 6
	},
/obj/effect/decal/cleanable/ants,
/turf/open/floor/grass,
/area/misc/condo)
"mS" = (
/obj/item/lighter,
/turf/open/misc/dirt/station,
/area/misc/condo)
"nF" = (
/obj/effect/turf_decal/weather/dirt{
	dir = 1
	},
/obj/structure/flora/bush/fullgrass/style_random,
/turf/open/floor/grass,
/area/misc/condo)
"nO" = (
/obj/structure/flora/rock/pile/jungle/style_random,
/obj/effect/turf_decal/weather/dirt{
	dir = 8
	},
/turf/open/floor/grass,
/area/misc/condo)
"of" = (
/turf/open/water,
/area/misc/condo)
"oh" = (
/obj/item/clothing/head/costume/garland/rainbowbunch,
/turf/open/floor/carpet/red,
/area/misc/condo)
"op" = (
/obj/structure/flora/bush/jungle/c/style_random,
/obj/effect/turf_decal/weather/dirt{
	dir = 5
	},
/turf/open/floor/grass,
/area/misc/condo)
"qh" = (
/obj/effect/turf_decal/weather/dirt{
	dir = 1
	},
/obj/structure/flora/rock/pile/jungle/style_random,
/turf/open/floor/grass,
/area/misc/condo)
"rA" = (
/obj/structure/flora/bush/jungle/b/style_random,
/obj/structure/flora/bush/flowers_pp/style_random,
/turf/open/floor/grass,
/area/misc/condo)
"sU" = (
/obj/structure/flora/bush/flowers_br/style_random,
/obj/machinery/vending/dorms,
/turf/open/floor/grass,
/area/misc/condo)
"tu" = (
/obj/structure/flora/bush/flowers_br/style_random,
/obj/effect/turf_decal/weather/dirt{
	dir = 4
	},
/turf/open/floor/grass,
/area/misc/condo)
"tN" = (
/obj/structure/flora/bush/fullgrass/style_random,
/obj/effect/turf_decal/weather/dirt,
/turf/open/floor/grass,
/area/misc/condo)
"tS" = (
/obj/structure/flora/bush/flowers_br/style_random,
/obj/effect/turf_decal/weather/dirt{
	dir = 5
	},
/turf/open/floor/grass,
/area/misc/condo)
"tU" = (
/obj/structure/bonfire,
/obj/effect/light_emitter/fake_outdoors,
/turf/open/misc/dirt/station,
/area/misc/condo)
"ui" = (
/obj/item/storage/basket,
/turf/open/floor/carpet/red,
/area/misc/condo)
"uI" = (
/obj/structure/flora/biolumi/lamp/weaklight,
/turf/open/water,
/area/misc/condo)
"uP" = (
/obj/structure/flora/tree/jungle,
/turf/open/floor/grass,
/area/misc/condo)
"vI" = (
/obj/structure/flora/bush/fullgrass/style_random,
/obj/effect/turf_decal/weather/dirt{
	dir = 4
	},
/turf/open/floor/grass,
/area/misc/condo)
"wg" = (
/obj/structure/flora/bush/fullgrass/style_random,
/obj/structure/flora/bush/flowers_yw/style_random,
/obj/effect/turf_decal/weather/dirt,
/turf/open/floor/grass,
/area/misc/condo)
"wl" = (
/obj/effect/turf_decal/weather/dirt{
	dir = 8
	},
/obj/structure/flora/rock/style_random,
/turf/open/floor/grass,
/area/misc/condo)
"xm" = (
/obj/effect/turf_decal/weather/dirt{
	dir = 9
	},
/turf/open/floor/grass,
/area/misc/condo)
"xE" = (
/obj/structure/chair/sofa/bench/right,
/obj/effect/turf_decal/weather/dirt{
	dir = 10
	},
/turf/open/floor/grass,
/area/misc/condo)
"xU" = (
/obj/effect/turf_decal/weather/dirt,
/obj/structure/flora/bush/fullgrass/style_random,
/obj/structure/flora/rock/pile/jungle/style_random,
/turf/open/floor/grass,
/area/misc/condo)
"yc" = (
/obj/effect/turf_decal/weather/dirt{
	dir = 10
	},
/obj/structure/flora/rock/pile/jungle/style_random,
/turf/open/floor/grass,
/area/misc/condo)
"yD" = (
/obj/structure/flora/bush/large/style_random,
/obj/effect/turf_decal/weather/dirt{
	dir = 8
	},
/turf/open/floor/grass,
/area/misc/condo)
"yI" = (
/obj/structure/flora/rock/pile/style_2,
/turf/open/floor/grass,
/area/misc/condo)
"za" = (
/obj/structure/flora/bush/fullgrass/style_random,
/obj/structure/flora/bush/flowers_br/style_random,
/turf/open/floor/grass,
/area/misc/condo)
"ze" = (
/turf/open/floor/carpet/red,
/area/misc/condo)
"zq" = (
/obj/effect/turf_decal/weather/dirt{
	dir = 4
	},
/turf/open/floor/grass,
/area/misc/condo)
"Ai" = (
/obj/structure/flora/bush/fullgrass/style_random,
/obj/effect/turf_decal/weather/dirt,
/obj/structure/flora/bush/flowers_br/style_random,
/turf/open/floor/grass,
/area/misc/condo)
"BW" = (
/obj/effect/turf_decal/weather/dirt{
	dir = 10
	},
/obj/structure/flora/bush/reed/style_random,
/turf/open/water,
/area/misc/condo)
"Ch" = (
/obj/structure/flora/bush/reed/style_random,
/turf/open/water,
/area/misc/condo)
"Cv" = (
/obj/structure/flora/bush/fullgrass/style_random,
/obj/effect/turf_decal/weather/dirt{
	dir = 9
	},
/obj/structure/flora/rock/style_random,
/turf/open/floor/grass,
/area/misc/condo)
"Dm" = (
/obj/effect/turf_decal/weather/dirt{
	dir = 1
	},
/obj/structure/flora/bush/flowers_br/style_random,
/turf/open/floor/grass,
/area/misc/condo)
"Dp" = (
/obj/structure/flora/bush/large/style_random,
/turf/open/floor/grass,
/area/misc/condo)
"Ep" = (
/obj/machinery/room_controller/directional/north,
/turf/open/misc/dirt/station,
/area/misc/condo)
"EB" = (
/obj/effect/turf_decal/weather/dirt{
	dir = 8
	},
/turf/open/floor/grass,
/area/misc/condo)
"Fv" = (
/obj/structure/flora/rock/pile{
	pixel_x = -3;
	pixel_y = -4
	},
/turf/open/floor/grass,
/area/misc/condo)
"FD" = (
/obj/effect/turf_decal/weather/dirt{
	dir = 8
	},
/obj/structure/flora/bush/sparsegrass/style_random,
/turf/open/floor/grass,
/area/misc/condo)
"FG" = (
/obj/structure/flora/bush/reed/style_random,
/obj/structure/spacevine{
	name = "thick vines";
	opacity = 1
	},
/turf/open/water,
/area/misc/condo)
"Gh" = (
/obj/structure/flora/tree/jungle,
/obj/effect/turf_decal/weather/dirt,
/turf/open/floor/grass,
/area/misc/condo)
"GE" = (
/obj/structure/spacevine{
	name = "thick vines";
	opacity = 1
	},
/turf/closed/indestructible/rock,
/area/misc/condo)
"Hw" = (
/obj/structure/spacevine{
	name = "thick vines";
	opacity = 1
	},
/turf/open/misc/dirt/station,
/area/misc/condo)
"HF" = (
/obj/structure/flora/bush/fullgrass/style_random,
/obj/effect/turf_decal/weather/dirt{
	dir = 6
	},
/turf/open/floor/grass,
/area/misc/condo)
"HI" = (
/obj/effect/turf_decal/weather/dirt{
	dir = 1
	},
/obj/structure/flora/bush/flowers_yw/style_random,
/turf/open/floor/grass,
/area/misc/condo)
"Id" = (
/obj/structure/flora/bush/fullgrass/style_random,
/obj/effect/turf_decal/weather/dirt{
	dir = 8
	},
/turf/open/floor/grass,
/area/misc/condo)
"It" = (
/obj/structure/flora/bush/flowers_pp/style_random,
/turf/open/floor/grass,
/area/misc/condo)
"IV" = (
/obj/structure/flora/rock/pile{
	pixel_x = -3;
	pixel_y = -4
	},
/obj/effect/turf_decal/weather/dirt{
	dir = 5
	},
/turf/open/floor/grass,
/area/misc/condo)
"Jz" = (
/obj/effect/turf_decal/weather/dirt{
	dir = 5
	},
/turf/open/floor/grass,
/area/misc/condo)
"Kd" = (
/obj/structure/closet/crate/freezer{
	name = "Cooler"
	},
/obj/item/reagent_containers/cup/glass/bottle/beer,
/obj/item/reagent_containers/cup/glass/bottle/beer,
/obj/item/reagent_containers/cup/glass/bottle/beer,
/obj/item/reagent_containers/cup/glass/bottle/beer/light,
/obj/item/reagent_containers/cup/glass/bottle/beer/light,
/obj/item/reagent_containers/cup/glass/bottle/beer/light,
/obj/item/reagent_containers/cup/soda_cans/cola,
/obj/item/reagent_containers/cup/soda_cans/cola,
/obj/item/reagent_containers/cup/soda_cans/cola,
/obj/item/reagent_containers/cup/glass/waterbottle,
/obj/item/reagent_containers/cup/glass/waterbottle,
/obj/item/reagent_containers/cup/soda_cans/dr_gibb,
/obj/item/reagent_containers/cup/soda_cans/dr_gibb,
/obj/item/reagent_containers/cup/soda_cans/blood_tea,
/obj/item/reagent_containers/cup/soda_cans/blood_tea,
/obj/item/reagent_containers/cup/soda_cans/blood_tea,
/obj/item/reagent_containers/cup/soda_cans/dr_gibb,
/obj/item/reagent_containers/cup/glass/waterbottle,
/obj/item/reagent_containers/cup/soda_cans/lemon_lime,
/obj/item/reagent_containers/cup/soda_cans/lemon_lime,
/obj/item/reagent_containers/cup/soda_cans/lemon_lime,
/obj/item/reagent_containers/cup/soda_cans/melon_soda,
/obj/item/reagent_containers/cup/soda_cans/melon_soda,
/obj/item/reagent_containers/cup/soda_cans/melon_soda,
/turf/open/floor/carpet/red,
/area/misc/condo)
"Ll" = (
/obj/effect/turf_decal/weather/dirt{
	dir = 10
	},
/obj/structure/flora/bush/flowers_br/style_random,
/turf/open/floor/grass,
/area/misc/condo)
"LD" = (
/obj/effect/turf_decal/weather/dirt{
	dir = 1
	},
/obj/structure/flora/bush/fullgrass/style_random,
/obj/structure/flora/bush/flowers_yw/style_random,
/turf/open/floor/grass,
/area/misc/condo)
"LS" = (
/obj/structure/fluff/beach_umbrella,
/turf/open/floor/carpet/red,
/area/misc/condo)
"Mk" = (
/turf/closed/indestructible/hoteldoor/fakedoor,
/area/misc/condo)
"MG" = (
/obj/structure/flora/rock/pile/jungle/style_random,
/obj/item/flashlight/lantern,
/turf/open/misc/dirt/station,
/area/misc/condo)
"NV" = (
/turf/open/misc/dirt/station,
/area/misc/condo)
"Oz" = (
/obj/effect/turf_decal/weather/dirt{
	dir = 10
	},
/turf/open/floor/grass,
/area/misc/condo)
"OX" = (
/obj/structure/flora/bush/jungle/a/style_random,
/turf/open/floor/grass,
/area/misc/condo)
"OY" = (
/obj/structure/flora/bush/fullgrass/style_random,
/obj/effect/turf_decal/weather/dirt{
	dir = 10
	},
/turf/open/floor/grass,
/area/misc/condo)
"PD" = (
/obj/structure/flora/bush/jungle/c/style_random,
/obj/structure/flora/bush/flowers_pp/style_random,
/obj/effect/turf_decal/weather/dirt{
	dir = 6
	},
/turf/open/floor/grass,
/area/misc/condo)
"Qe" = (
/obj/structure/flora/bush/jungle/a/style_random,
/obj/structure/flora/bush/flowers_br/style_random,
/turf/open/floor/grass,
/area/misc/condo)
"Sb" = (
/obj/structure/flora/bush/fullgrass/style_random,
/obj/effect/turf_decal/weather/dirt{
	dir = 9
	},
/turf/open/floor/grass,
/area/misc/condo)
"Sv" = (
/obj/structure/chair/stool/directional/south,
/obj/item/instrument/guitar,
/turf/open/misc/dirt/station,
/area/misc/condo)
"Ty" = (
/obj/structure/flora/rock/pile/style_2,
/turf/open/misc/dirt/station,
/area/misc/condo)
"Uh" = (
/obj/effect/turf_decal/weather/dirt{
	dir = 1
	},
/turf/open/floor/grass,
/area/misc/condo)
"UQ" = (
/obj/effect/turf_decal/weather/dirt,
/obj/structure/chair/sofa/bench/left,
/turf/open/floor/grass,
/area/misc/condo)
"Vz" = (
/obj/structure/spacevine{
	name = "thick vines";
	opacity = 1
	},
/obj/effect/turf_decal/weather/dirt{
	dir = 9
	},
/turf/open/floor/grass,
/area/misc/condo)
"WD" = (
/obj/structure/flora/bush/sparsegrass/style_random,
/turf/open/misc/dirt/station,
/area/misc/condo)
"Xc" = (
/obj/structure/flora/bush/sparsegrass/style_random,
/obj/structure/spacevine{
	name = "thick vines";
	opacity = 1
	},
/turf/open/misc/dirt/station,
/area/misc/condo)
"Yk" = (
/obj/effect/turf_decal/weather/dirt{
	dir = 1
	},
/obj/structure/flora/bush/flowers_pp/style_random,
/turf/open/floor/grass,
/area/misc/condo)
"Yr" = (
/obj/structure/flora/bush/fullgrass/style_random,
/obj/effect/turf_decal/weather/dirt{
	dir = 1
	},
/turf/open/floor/grass,
/area/misc/condo)
"Yt" = (
/obj/structure/flora/bush/flowers_yw/style_random,
/turf/open/floor/grass,
/area/misc/condo)
"YL" = (
/obj/effect/turf_decal/weather/dirt{
	dir = 5
	},
/obj/structure/flora/bush/jungle/b/style_random,
/turf/open/floor/grass,
/area/misc/condo)
"Zh" = (
/obj/effect/turf_decal/weather/dirt{
	dir = 10
	},
/turf/open/water,
/area/misc/condo)

(1,1,1) = {"
iU
GE
GE
GE
iU
GE
Mk
GE
iU
GE
GE
GE
GE
GE
iU
"}
(2,1,1) = {"
GE
GE
Sb
wl
OY
GE
Ep
MG
iU
GE
GE
Cv
kG
GE
iU
"}
(3,1,1) = {"
GE
xm
iW
sU
uP
GE
Xc
Hw
Vz
nO
yD
Yt
xU
iU
iU
"}
(4,1,1) = {"
GE
el
bv
It
iW
xE
NV
NV
LD
Qe
uP
kI
kv
iU
iU
"}
(5,1,1) = {"
iU
Yr
bv
bv
bv
UQ
NV
NV
Jz
fi
bv
bv
ii
GE
iU
"}
(6,1,1) = {"
iU
Uh
bv
uP
fi
Ai
NV
NV
Ty
Yk
yI
OX
kv
GE
GE
"}
(7,1,1) = {"
iU
YL
bv
oh
LS
jF
NV
NV
NV
Jz
iW
fi
za
yc
GE
"}
(8,1,1) = {"
iU
iU
qh
Kd
ze
NV
NV
kz
NV
NV
nF
fi
uP
iA
GE
"}
(9,1,1) = {"
iU
GE
Yr
ui
ze
Sv
kz
tU
kz
gw
Uh
bv
fi
lp
iU
"}
(10,1,1) = {"
iU
GE
tS
bv
Oz
NV
WD
kz
mS
hz
Dm
bv
tN
GE
iU
"}
(11,1,1) = {"
iU
GE
BW
IV
It
Ll
NV
hU
NV
xm
OX
fi
wg
GE
iU
"}
(12,1,1) = {"
iU
iU
of
Zh
gO
Dp
EB
FD
Id
rA
fi
bv
yI
kG
iU
"}
(13,1,1) = {"
iU
iU
Ch
of
Zh
HI
Fv
Yt
fi
Dp
fi
fi
fi
PD
iU
"}
(14,1,1) = {"
iU
FG
uI
of
ed
nF
fi
fi
cg
fi
fi
fi
Gh
GE
iU
"}
(15,1,1) = {"
iU
iU
of
Ch
ed
op
tu
vI
di
zq
zq
di
HF
GE
iU
"}
(16,1,1) = {"
iU
iU
iU
iU
iU
iU
iU
GE
GE
GE
GE
iU
iU
iU
iU
"}
