//MAP CONVERTED BY dmm2tgm.py THIS HEADER COMMENT PREVENTS RECONVERSION, DO NOT REMOVE
"aO" = (
/obj/structure/flora/bush/fullgrass/style_random,
/obj/structure/flora/bush/flowers_yw/style_random,
/obj/effect/turf_decal/weather/dirt,
/turf/open/floor/grass,
/area/misc/condo)
"aQ" = (
/obj/structure/flora/bush/jungle/a/style_random,
/obj/structure/flora/bush/flowers_br/style_random,
/turf/open/floor/grass,
/area/misc/condo)
"bf" = (
/obj/effect/turf_decal/weather/dirt{
	dir = 8
	},
/obj/structure/flora/rock/style_random,
/turf/open/floor/grass,
/area/misc/condo)
"bJ" = (
/obj/structure/fluff/beach_umbrella,
/turf/open/floor/carpet/red,
/area/misc/condo)
"bR" = (
/obj/effect/turf_decal/weather/dirt{
	dir = 1
	},
/obj/structure/flora/bush/fullgrass/style_random,
/turf/open/floor/grass,
/area/misc/condo)
"cE" = (
/obj/structure/flora/tree/jungle,
/obj/effect/turf_decal/weather/dirt,
/turf/open/floor/grass,
/area/misc/condo)
"db" = (
/obj/effect/turf_decal/weather/dirt{
	dir = 10
	},
/turf/open/floor/grass,
/area/misc/condo)
"dZ" = (
/obj/structure/flora/bush/fullgrass/style_random,
/obj/effect/turf_decal/weather/dirt{
	dir = 9
	},
/obj/structure/flora/rock/style_random,
/turf/open/floor/grass,
/area/misc/condo)
"ev" = (
/obj/structure/flora/bush/jungle/c/style_random,
/obj/structure/flora/bush/flowers_pp/style_random,
/obj/effect/turf_decal/weather/dirt{
	dir = 6
	},
/turf/open/floor/grass,
/area/misc/condo)
"eN" = (
/obj/structure/flora/rock/pile/jungle/style_random,
/turf/open/misc/dirt/station,
/area/misc/condo)
"eW" = (
/obj/structure/flora/bush/flowers_br/style_random,
/obj/effect/turf_decal/weather/dirt{
	dir = 4
	},
/turf/open/floor/grass,
/area/misc/condo)
"fw" = (
/obj/structure/flora/bush/flowers_yw/style_random,
/obj/effect/turf_decal/weather/dirt{
	dir = 1
	},
/turf/open/floor/grass,
/area/misc/condo)
"fL" = (
/obj/effect/turf_decal/weather/dirt{
	dir = 6
	},
/obj/effect/decal/cleanable/ants,
/turf/open/floor/grass,
/area/misc/condo)
"hR" = (
/obj/structure/flora/rock/pile{
	pixel_x = -3;
	pixel_y = -4
	},
/turf/open/floor/grass,
/area/misc/condo)
"ia" = (
/obj/structure/flora/rock/pile{
	pixel_x = -3;
	pixel_y = -4
	},
/obj/effect/turf_decal/weather/dirt{
	dir = 5
	},
/turf/open/floor/grass,
/area/misc/condo)
"jW" = (
/obj/effect/turf_decal/weather/dirt{
	dir = 9
	},
/turf/open/floor/grass,
/area/misc/condo)
"kF" = (
/obj/structure/chair/stool/directional/south,
/obj/item/instrument/guitar,
/turf/open/misc/dirt/station,
/area/misc/condo)
"lu" = (
/obj/structure/closet/crate/freezer{
	name = "Cooler"
	},
/obj/item/reagent_containers/cup/glass/bottle/beer,
/obj/item/reagent_containers/cup/glass/bottle/beer,
/obj/item/reagent_containers/cup/glass/bottle/beer,
/obj/item/reagent_containers/cup/glass/bottle/beer/light,
/obj/item/reagent_containers/cup/glass/bottle/beer/light,
/obj/item/reagent_containers/cup/glass/bottle/beer/light,
/obj/item/reagent_containers/cup/soda_cans/cola,
/obj/item/reagent_containers/cup/soda_cans/cola,
/obj/item/reagent_containers/cup/soda_cans/cola,
/obj/item/reagent_containers/cup/glass/waterbottle,
/obj/item/reagent_containers/cup/glass/waterbottle,
/obj/item/reagent_containers/cup/soda_cans/dr_gibb,
/obj/item/reagent_containers/cup/soda_cans/dr_gibb,
/obj/item/reagent_containers/cup/soda_cans/blood_tea,
/obj/item/reagent_containers/cup/soda_cans/blood_tea,
/obj/item/reagent_containers/cup/soda_cans/blood_tea,
/obj/item/reagent_containers/cup/soda_cans/dr_gibb,
/obj/item/reagent_containers/cup/glass/waterbottle,
/obj/item/reagent_containers/cup/soda_cans/lemon_lime,
/obj/item/reagent_containers/cup/soda_cans/lemon_lime,
/obj/item/reagent_containers/cup/soda_cans/lemon_lime,
/obj/item/reagent_containers/cup/soda_cans/melon_soda,
/obj/item/reagent_containers/cup/soda_cans/melon_soda,
/obj/item/reagent_containers/cup/soda_cans/melon_soda,
/turf/open/floor/carpet/red,
/area/misc/condo)
"lz" = (
/obj/structure/flora/bush/flowers_br/style_random,
/obj/machinery/vending/dorms,
/turf/open/floor/grass,
/area/misc/condo)
"lD" = (
/obj/structure/flora/rock/pile/jungle/style_random,
/obj/effect/turf_decal/weather/dirt{
	dir = 8
	},
/turf/open/floor/grass,
/area/misc/condo)
"mx" = (
/obj/structure/flora/rock/pile/jungle/style_random,
/obj/item/flashlight/lantern,
/turf/open/misc/dirt/station,
/area/misc/condo)
"ow" = (
/obj/effect/turf_decal/weather/dirt{
	dir = 8
	},
/obj/structure/flora/bush/sparsegrass/style_random,
/turf/open/floor/grass,
/area/misc/condo)
"pc" = (
/turf/open/misc/dirt/station,
/area/misc/condo)
"pk" = (
/obj/effect/turf_decal/weather/dirt{
	dir = 10
	},
/turf/open/water,
/area/misc/condo)
"qA" = (
/obj/structure/bonfire/prelit,
/turf/open/misc/dirt/station,
/area/misc/condo)
"rg" = (
/obj/structure/flora/bush/sparsegrass/style_random,
/obj/structure/spacevine{
	name = "thick vines";
	opacity = 1
	},
/turf/open/misc/dirt/station,
/area/misc/condo)
"sb" = (
/obj/structure/chair/stool/directional/west,
/turf/open/misc/dirt/station,
/area/misc/condo)
"sc" = (
/obj/structure/flora/bush/fullgrass/style_random,
/obj/effect/turf_decal/weather/dirt{
	dir = 8
	},
/turf/open/floor/grass,
/area/misc/condo)
"sS" = (
/obj/structure/flora/bush/fullgrass/style_random,
/obj/effect/turf_decal/weather/dirt{
	dir = 6
	},
/turf/open/floor/grass,
/area/misc/condo)
"ti" = (
/obj/structure/flora/rock/style_random,
/obj/structure/flora/bush/jungle/c/style_random,
/obj/effect/turf_decal/weather/dirt,
/turf/open/floor/grass,
/area/misc/condo)
"ud" = (
/obj/structure/flora/bush/jungle/b/style_random,
/obj/structure/flora/bush/flowers_pp/style_random,
/turf/open/floor/grass,
/area/misc/condo)
"uR" = (
/obj/structure/flora/bush/fullgrass/style_random,
/obj/effect/turf_decal/weather/dirt{
	dir = 10
	},
/turf/open/floor/grass,
/area/misc/condo)
"vD" = (
/obj/effect/turf_decal/weather/dirt{
	dir = 5
	},
/obj/structure/flora/bush/jungle/b/style_random,
/turf/open/floor/grass,
/area/misc/condo)
"wO" = (
/turf/open/floor/grass,
/area/misc/condo)
"xm" = (
/obj/structure/flora/biolumi/lamp/weaklight,
/turf/open/water,
/area/misc/condo)
"xo" = (
/obj/structure/spacevine{
	name = "thick vines";
	opacity = 1
	},
/obj/effect/turf_decal/weather/dirt{
	dir = 9
	},
/turf/open/floor/grass,
/area/misc/condo)
"yj" = (
/obj/item/clothing/head/costume/garland/rainbowbunch,
/turf/open/floor/carpet/red,
/area/misc/condo)
"yO" = (
/obj/machinery/room_controller/directional/north,
/turf/open/misc/dirt/station,
/area/misc/condo)
"yZ" = (
/obj/structure/flora/bush/large/style_random,
/obj/effect/turf_decal/weather/dirt{
	dir = 10
	},
/turf/open/floor/grass,
/area/misc/condo)
"zm" = (
/obj/structure/chair/sofa/bench/right,
/obj/effect/turf_decal/weather/dirt{
	dir = 10
	},
/turf/open/floor/grass,
/area/misc/condo)
"Bf" = (
/obj/structure/flora/bush/fullgrass/style_random,
/obj/effect/turf_decal/weather/dirt{
	dir = 4
	},
/turf/open/floor/grass,
/area/misc/condo)
"Bn" = (
/obj/item/flashlight/lantern,
/turf/open/floor/carpet/red,
/area/misc/condo)
"Co" = (
/obj/structure/flora/rock/pile/style_2,
/turf/open/floor/grass,
/area/misc/condo)
"Do" = (
/obj/effect/turf_decal/weather/dirt{
	dir = 1
	},
/obj/structure/flora/rock/pile/jungle/style_random,
/turf/open/floor/grass,
/area/misc/condo)
"DH" = (
/obj/structure/flora/bush/fullgrass/style_random,
/obj/effect/turf_decal/weather/dirt,
/turf/open/floor/grass,
/area/misc/condo)
"Ea" = (
/obj/structure/flora/rock/pile/style_2,
/turf/open/misc/dirt/station,
/area/misc/condo)
"Eb" = (
/obj/effect/turf_decal/weather/dirt{
	dir = 5
	},
/turf/open/floor/grass,
/area/misc/condo)
"Ei" = (
/obj/effect/turf_decal/weather/dirt{
	dir = 1
	},
/obj/structure/flora/bush/fullgrass/style_random,
/obj/structure/flora/bush/flowers_yw/style_random,
/turf/open/floor/grass,
/area/misc/condo)
"ED" = (
/obj/structure/flora/bush/fullgrass/style_random,
/obj/effect/turf_decal/weather/dirt{
	dir = 9
	},
/turf/open/floor/grass,
/area/misc/condo)
"EN" = (
/obj/effect/turf_decal/weather/dirt{
	dir = 10
	},
/obj/structure/flora/rock/pile/jungle/style_random,
/turf/open/floor/grass,
/area/misc/condo)
"EP" = (
/obj/structure/flora/tree/jungle,
/turf/open/floor/grass,
/area/misc/condo)
"FL" = (
/obj/effect/turf_decal/weather/dirt{
	dir = 4
	},
/turf/open/floor/grass,
/area/misc/condo)
"HB" = (
/turf/closed/indestructible/hoteldoor/fakedoor,
/area/misc/condo)
"HX" = (
/obj/structure/flora/bush/fullgrass/style_random,
/obj/structure/flora/bush/flowers_br/style_random,
/turf/open/floor/grass,
/area/misc/condo)
"JF" = (
/obj/effect/turf_decal/weather/dirt{
	dir = 8
	},
/turf/open/floor/grass,
/area/misc/condo)
"Kk" = (
/obj/effect/turf_decal/weather/dirt,
/turf/open/floor/grass,
/area/misc/condo)
"Kr" = (
/obj/effect/turf_decal/weather/dirt{
	dir = 5
	},
/obj/structure/flora/bush/fullgrass/style_random,
/turf/open/floor/grass,
/area/misc/condo)
"Kz" = (
/obj/effect/turf_decal/weather/dirt{
	dir = 1
	},
/obj/structure/flora/bush/flowers_br/style_random,
/turf/open/floor/grass,
/area/misc/condo)
"KD" = (
/obj/structure/flora/bush/sparsegrass/style_random,
/turf/open/misc/dirt/station,
/area/misc/condo)
"Le" = (
/obj/effect/turf_decal/weather/dirt{
	dir = 10
	},
/obj/structure/flora/bush/flowers_br/style_random,
/turf/open/floor/grass,
/area/misc/condo)
"Lr" = (
/obj/effect/turf_decal/weather/dirt{
	dir = 1
	},
/obj/structure/flora/bush/flowers_pp/style_random,
/turf/open/floor/grass,
/area/misc/condo)
"Ls" = (
/obj/structure/flora/bush/reed/style_random,
/turf/open/water,
/area/misc/condo)
"MN" = (
/obj/structure/flora/bush/fullgrass/style_random,
/obj/structure/flora/bush/flowers_pp/style_random,
/turf/open/floor/grass,
/area/misc/condo)
"MU" = (
/obj/structure/flora/bush/jungle/c/style_random,
/obj/effect/turf_decal/weather/dirt,
/turf/open/floor/grass,
/area/misc/condo)
"MW" = (
/obj/structure/flora/bush/reed/style_random,
/obj/structure/spacevine{
	name = "thick vines";
	opacity = 1
	},
/turf/open/water,
/area/misc/condo)
"Nj" = (
/obj/structure/flora/bush/flowers_pp/style_random,
/turf/open/floor/grass,
/area/misc/condo)
"Oi" = (
/turf/open/water,
/area/misc/condo)
"Pc" = (
/obj/effect/turf_decal/weather/dirt,
/obj/structure/chair/sofa/bench/left,
/turf/open/floor/grass,
/area/misc/condo)
"Pm" = (
/obj/effect/turf_decal/weather/dirt{
	dir = 4
	},
/obj/structure/flora/rock/style_random,
/turf/open/floor/grass,
/area/misc/condo)
"PF" = (
/obj/structure/flora/bush/fullgrass/style_random,
/obj/effect/turf_decal/weather/dirt,
/obj/structure/flora/bush/flowers_br/style_random,
/turf/open/floor/grass,
/area/misc/condo)
"PL" = (
/obj/effect/turf_decal/weather/dirt{
	dir = 1
	},
/turf/open/floor/grass,
/area/misc/condo)
"Qf" = (
/obj/structure/flora/bush/large/style_random,
/obj/effect/turf_decal/weather/dirt{
	dir = 8
	},
/turf/open/floor/grass,
/area/misc/condo)
"Qr" = (
/turf/open/floor/carpet/red,
/area/misc/condo)
"Qs" = (
/obj/structure/flora/bush/flowers_br/style_random,
/obj/effect/turf_decal/weather/dirt{
	dir = 5
	},
/turf/open/floor/grass,
/area/misc/condo)
"RC" = (
/obj/structure/flora/bush/jungle/a/style_random,
/turf/open/floor/grass,
/area/misc/condo)
"RE" = (
/obj/structure/chair/stool/directional/north,
/turf/open/misc/dirt/station,
/area/misc/condo)
"Sb" = (
/obj/item/storage/basket,
/turf/open/floor/carpet/red,
/area/misc/condo)
"Sl" = (
/obj/effect/turf_decal/weather/dirt,
/turf/open/water,
/area/misc/condo)
"Sn" = (
/obj/structure/flora/bush/flowers_br/style_random,
/turf/open/floor/grass,
/area/misc/condo)
"Su" = (
/turf/closed/indestructible/rock,
/area/misc/condo)
"SS" = (
/obj/effect/turf_decal/weather/dirt{
	dir = 10
	},
/obj/structure/flora/bush/reed/style_random,
/turf/open/water,
/area/misc/condo)
"SV" = (
/obj/effect/turf_decal/weather/dirt,
/obj/structure/flora/bush/fullgrass/style_random,
/obj/structure/flora/rock/pile/jungle/style_random,
/turf/open/floor/grass,
/area/misc/condo)
"SY" = (
/obj/structure/flora/bush/jungle/c/style_random,
/obj/effect/turf_decal/weather/dirt{
	dir = 5
	},
/turf/open/floor/grass,
/area/misc/condo)
"TJ" = (
/obj/structure/flora/bush/fullgrass/style_random,
/obj/effect/turf_decal/weather/dirt{
	dir = 1
	},
/turf/open/floor/grass,
/area/misc/condo)
"UD" = (
/obj/structure/spacevine{
	name = "thick vines";
	opacity = 1
	},
/turf/open/misc/dirt/station,
/area/misc/condo)
"Vu" = (
/obj/effect/turf_decal/weather/dirt{
	dir = 1
	},
/obj/structure/flora/bush/flowers_yw/style_random,
/turf/open/floor/grass,
/area/misc/condo)
"Ws" = (
/obj/structure/flora/bush/fullgrass/style_random,
/turf/open/floor/grass,
/area/misc/condo)
"Wt" = (
/obj/structure/flora/bush/flowers_yw/style_random,
/turf/open/floor/grass,
/area/misc/condo)
"WF" = (
/obj/structure/flora/bush/large/style_random,
/turf/open/floor/grass,
/area/misc/condo)
"XF" = (
/obj/structure/flora/bush/jungle/b/style_random,
/turf/open/floor/grass,
/area/misc/condo)
"Yi" = (
/obj/structure/spacevine{
	name = "thick vines";
	opacity = 1
	},
/turf/closed/indestructible/rock,
/area/misc/condo)
"ZI" = (
/obj/effect/turf_decal/weather/dirt{
	dir = 6
	},
/turf/open/floor/grass,
/area/misc/condo)

(1,1,1) = {"
Su
Yi
Yi
Yi
Su
Yi
HB
Yi
Su
Yi
Yi
Yi
Yi
Yi
Su
"}
(2,1,1) = {"
Yi
Yi
ED
bf
uR
Yi
yO
mx
Su
Yi
Yi
dZ
yZ
Yi
Su
"}
(3,1,1) = {"
Yi
jW
XF
lz
EP
Yi
rg
UD
xo
lD
Qf
Wt
SV
Su
Su
"}
(4,1,1) = {"
Yi
fw
Ws
Nj
XF
zm
pc
pc
Ei
aQ
EP
Sn
Kk
Su
Su
"}
(5,1,1) = {"
Su
TJ
Ws
Ws
Ws
Pc
pc
pc
Eb
wO
Ws
Ws
MU
Yi
Su
"}
(6,1,1) = {"
Su
PL
Ws
EP
wO
PF
pc
pc
Ea
Lr
Co
RC
Kk
Yi
Yi
"}
(7,1,1) = {"
Su
vD
Ws
yj
bJ
ZI
pc
pc
pc
Eb
XF
wO
HX
EN
Yi
"}
(8,1,1) = {"
Su
Su
Do
lu
Qr
pc
pc
pc
pc
pc
bR
wO
EP
ti
Yi
"}
(9,1,1) = {"
Su
Yi
TJ
Sb
Bn
kF
pc
qA
pc
RE
PL
Ws
wO
fL
Su
"}
(10,1,1) = {"
Su
Yi
Qs
Ws
db
pc
KD
pc
pc
eN
Kz
Ws
DH
Yi
Su
"}
(11,1,1) = {"
Su
Yi
SS
ia
Nj
Le
pc
sb
pc
jW
RC
wO
aO
Yi
Su
"}
(12,1,1) = {"
Su
Su
Oi
pk
Kr
WF
JF
ow
sc
ud
wO
Ws
Co
yZ
Su
"}
(13,1,1) = {"
Su
Su
Ls
Oi
pk
Vu
hR
Wt
wO
WF
wO
wO
wO
ev
Su
"}
(14,1,1) = {"
Su
MW
xm
Oi
Sl
bR
wO
wO
MN
wO
wO
wO
cE
Yi
Su
"}
(15,1,1) = {"
Su
Su
Oi
Ls
Sl
SY
eW
Bf
Pm
FL
FL
Pm
sS
Yi
Su
"}
(16,1,1) = {"
Su
Su
Su
Su
Su
Su
Su
Yi
Yi
Yi
Yi
Su
Su
Su
Su
"}
