//MAP CONVERTED BY dmm2tgm.py THIS HEADER COMMENT PREVENTS RECONVERSION, DO NOT REMOVE
"ah" = (
/obj/effect/turf_decal/siding/wood/end{
	dir = 8
	},
/turf/open/floor/wood,
/area/misc/condo)
"as" = (
/obj/structure/table/wood,
/obj/item/dice/d20{
	pixel_y = -10
	},
/turf/open/floor/carpet/red,
/area/misc/condo)
"au" = (
/obj/structure/table/wood,
/turf/open/floor/wood,
/area/misc/condo)
"az" = (
/obj/structure/table/wood,
/obj/item/paper_bin/carbon{
	pixel_y = 10;
	pixel_x = -8
	},
/obj/item/pen{
	pixel_y = 10;
	pixel_x = -7
	},
/turf/open/floor/wood,
/area/misc/condo)
"aD" = (
/obj/effect/turf_decal/siding/wood,
/obj/effect/turf_decal/siding/wood{
	dir = 1
	},
/obj/structure/chair/office,
/turf/open/floor/wood,
/area/misc/condo)
"bD" = (
/turf/closed/indestructible/rock,
/area/misc/condo)
"cC" = (
/obj/machinery/light/directional/north,
/obj/machinery/photocopier/gratis/infinite,
/turf/open/floor/iron/grimy,
/area/misc/condo)
"dB" = (
/obj/structure/table/wood,
/turf/open/floor/carpet/red,
/area/misc/condo)
"dE" = (
/obj/effect/turf_decal/siding/wood{
	dir = 9
	},
/turf/open/floor/carpet/black,
/area/misc/condo)
"dG" = (
/obj/structure/chair/comfy/brown{
	dir = 8
	},
/obj/effect/turf_decal/siding/wood,
/turf/open/floor/wood,
/area/misc/condo)
"ef" = (
/obj/effect/turf_decal/siding/wood{
	dir = 8
	},
/obj/structure/chair/comfy/brown{
	buildstackamount = 0;
	color = "#c45c57";
	dir = 8;
	pixel_y = -8
	},
/turf/open/floor/carpet/black,
/area/misc/condo)
"ez" = (
/obj/effect/turf_decal/siding/wood{
	dir = 1
	},
/turf/open/floor/wood,
/area/misc/condo)
"fQ" = (
/turf/open/floor/wood,
/area/misc/condo)
"fR" = (
/turf/open/floor/iron/grimy,
/area/misc/condo)
"gA" = (
/obj/structure/displaycase/trophy,
/turf/open/floor/carpet/red,
/area/misc/condo)
"gT" = (
/obj/effect/spawner/structure/window,
/turf/open/floor/plating,
/area/misc/condo)
"gY" = (
/obj/structure/table/wood,
/obj/item/reagent_containers/cup/glass/coffee,
/turf/open/floor/wood,
/area/misc/condo)
"hu" = (
/obj/effect/turf_decal/siding/wood{
	dir = 8
	},
/turf/open/floor/carpet/black,
/area/misc/condo)
"hv" = (
/obj/effect/turf_decal/siding/wood,
/obj/effect/turf_decal/siding/wood/corner{
	dir = 1
	},
/turf/open/floor/wood,
/area/misc/condo)
"id" = (
/obj/structure/chair/comfy/beige{
	dir = 4
	},
/obj/effect/turf_decal/siding/wood/end{
	dir = 8
	},
/turf/open/floor/wood,
/area/misc/condo)
"iB" = (
/turf/open/floor/carpet/red,
/area/misc/condo)
"iS" = (
/obj/structure/bookcase/random/fiction,
/turf/open/floor/wood,
/area/misc/condo)
"kp" = (
/obj/machinery/bookbinder,
/obj/effect/turf_decal/siding/wood,
/obj/effect/turf_decal/siding/wood{
	dir = 1
	},
/turf/open/floor/wood,
/area/misc/condo)
"kQ" = (
/obj/effect/turf_decal/siding/wood/end{
	dir = 4
	},
/turf/open/floor/iron/grimy,
/area/misc/condo)
"le" = (
/obj/structure/table/wood,
/obj/effect/turf_decal/siding/wood,
/obj/item/toy/figure/wizard{
	pixel_y = -2;
	pixel_x = -8
	},
/obj/item/toy/figure/ninja{
	pixel_y = -2
	},
/obj/item/toy/figure/secofficer{
	pixel_y = -2;
	pixel_x = 8
	},
/obj/item/toy/figure/cmo{
	pixel_y = 13
	},
/obj/item/toy/figure/curator{
	pixel_y = 13;
	pixel_x = 8
	},
/turf/open/floor/carpet/black,
/area/misc/condo)
"lf" = (
/obj/structure/table/wood,
/obj/item/stack/sheet/mineral/sandstone/thirty,
/obj/item/stack/sheet/mineral/gold,
/obj/item/stack/sheet/mineral/gold,
/obj/item/stack/sheet/mineral/silver,
/obj/item/stack/sheet/mineral/silver,
/obj/item/stack/sheet/mineral/gold,
/obj/item/stack/sheet/mineral/silver,
/obj/item/stack/sheet/mineral/diamond/five,
/turf/open/floor/iron/sepia,
/area/misc/condo)
"lt" = (
/obj/structure/easel,
/obj/effect/turf_decal/siding/wood{
	dir = 5
	},
/obj/effect/turf_decal/siding/wood/corner{
	dir = 8
	},
/obj/item/canvas/twentythree_twentythree,
/obj/item/canvas/twentythree_twentythree,
/obj/item/canvas/twentythree_nineteen,
/obj/item/canvas/fortyfive_twentyseven{
	pixel_x = 4;
	pixel_y = 4
	},
/obj/item/canvas/nineteen_nineteen,
/obj/structure/sign/painting/library{
	pixel_x = 32
	},
/turf/open/floor/wood,
/area/misc/condo)
"lz" = (
/obj/structure/table/wood,
/obj/item/paper_bin/carbon{
	pixel_y = 1
	},
/obj/item/pen,
/turf/open/floor/carpet/black,
/area/misc/condo)
"lM" = (
/obj/structure/easel,
/obj/effect/turf_decal/siding/wood{
	dir = 4
	},
/obj/effect/turf_decal/siding/wood{
	dir = 8
	},
/obj/item/canvas/twentythree_twentythree,
/obj/item/canvas/twentythree_twentythree,
/obj/item/canvas/twentythree_nineteen,
/obj/item/canvas/fortyfive_twentyseven{
	pixel_x = 4;
	pixel_y = 4
	},
/obj/item/canvas/nineteen_nineteen,
/obj/machinery/light/directional/east,
/turf/open/floor/wood,
/area/misc/condo)
"nD" = (
/obj/structure/table/wood,
/obj/effect/turf_decal/siding/wood,
/obj/machinery/light/directional/south,
/obj/item/stack/spacecash/c10,
/obj/item/stack/spacecash/c1{
	pixel_x = 0;
	pixel_y = 3
	},
/turf/open/floor/wood,
/area/misc/condo)
"nP" = (
/obj/structure/table/wood,
/obj/machinery/computer/libraryconsole/bookmanagement,
/obj/effect/turf_decal/siding/wood,
/obj/effect/turf_decal/siding/wood{
	dir = 1
	},
/turf/open/floor/iron/grimy,
/area/misc/condo)
"os" = (
/obj/structure/bookcase/random/religion,
/turf/open/floor/wood,
/area/misc/condo)
"pN" = (
/obj/effect/turf_decal/siding/wood,
/obj/effect/turf_decal/siding/wood,
/obj/structure/chair/office,
/turf/open/floor/wood,
/area/misc/condo)
"qm" = (
/obj/structure/table/wood/fancy,
/obj/structure/sign/painting/library{
	pixel_x = -32
	},
/turf/open/floor/wood,
/area/misc/condo)
"rv" = (
/obj/structure/sign/painting/large/library{
	pixel_y = -37
	},
/obj/effect/turf_decal/siding/wood{
	dir = 1
	},
/obj/effect/turf_decal/siding/wood,
/obj/item/kirbyplants/random,
/turf/open/floor/wood,
/area/misc/condo)
"rW" = (
/obj/effect/turf_decal/siding/wood{
	dir = 1
	},
/obj/effect/turf_decal/siding/wood,
/obj/structure/chair/office{
	dir = 1
	},
/turf/open/floor/wood,
/area/misc/condo)
"sC" = (
/obj/structure/chair/office{
	dir = 8
	},
/turf/open/floor/carpet/green,
/area/misc/condo)
"sH" = (
/obj/machinery/vending/games,
/obj/structure/sign/painting/library{
	pixel_y = 33
	},
/obj/effect/turf_decal/siding/wood{
	dir = 9
	},
/obj/effect/turf_decal/siding/wood/corner,
/turf/open/floor/wood,
/area/misc/condo)
"tb" = (
/obj/structure/table/wood,
/obj/item/paper_bin/carbon{
	pixel_y = 2;
	pixel_x = 6
	},
/obj/item/pen/fountain{
	pixel_y = -2;
	pixel_x = -9
	},
/obj/item/pen{
	pixel_x = 6;
	pixel_y = 3
	},
/obj/machinery/light/directional/north,
/turf/open/floor/iron/grimy,
/area/misc/condo)
"tq" = (
/obj/effect/turf_decal/siding/wood{
	dir = 9
	},
/obj/effect/turf_decal/siding/wood/corner,
/turf/open/floor/wood,
/area/misc/condo)
"tr" = (
/obj/structure/table/wood,
/obj/item/paper_bin/carbon{
	pixel_y = -7
	},
/obj/item/pen/fourcolor{
	pixel_y = -7
	},
/obj/machinery/light/directional/east,
/turf/open/floor/carpet/black,
/area/misc/condo)
"tt" = (
/obj/structure/table/wood,
/obj/effect/turf_decal/siding/wood{
	dir = 8
	},
/obj/effect/turf_decal/siding/wood{
	dir = 4
	},
/obj/item/toy/eldritch_book,
/turf/open/floor/iron/grimy,
/area/misc/condo)
"uK" = (
/obj/structure/chair/office{
	dir = 8
	},
/turf/open/floor/wood,
/area/misc/condo)
"vR" = (
/turf/closed/indestructible/hoteldoor/fakedoor,
/area/misc/condo)
"xW" = (
/obj/structure/sign/painting/library{
	pixel_y = -32
	},
/obj/effect/turf_decal/siding/wood{
	dir = 10
	},
/obj/effect/turf_decal/siding/wood/corner{
	dir = 4
	},
/turf/open/floor/wood,
/area/misc/condo)
"yk" = (
/obj/machinery/modular_computer/preset/curator{
	dir = 1
	},
/obj/machinery/light/directional/east,
/turf/open/floor/carpet/green,
/area/misc/condo)
"yl" = (
/obj/effect/turf_decal/siding/wood{
	dir = 4
	},
/obj/effect/turf_decal/siding/wood{
	dir = 8
	},
/obj/machinery/light/small/dim/directional/west,
/turf/open/floor/wood,
/area/misc/condo)
"yC" = (
/obj/effect/turf_decal/siding/wood{
	dir = 1
	},
/obj/effect/turf_decal/siding/wood/corner{
	dir = 8
	},
/turf/open/floor/wood,
/area/misc/condo)
"zQ" = (
/obj/structure/chair/office{
	dir = 4
	},
/obj/effect/turf_decal/siding/wood{
	dir = 8
	},
/turf/open/floor/wood,
/area/misc/condo)
"AC" = (
/obj/effect/turf_decal/siding/wood/corner{
	dir = 1
	},
/obj/effect/turf_decal/siding/wood{
	dir = 6
	},
/obj/structure/sign/painting/library{
	pixel_x = 32
	},
/obj/machinery/vending/dorms,
/turf/open/floor/wood,
/area/misc/condo)
"AJ" = (
/obj/structure/bookcase/random/nonfiction,
/turf/open/floor/wood,
/area/misc/condo)
"AK" = (
/obj/structure/table/wood,
/obj/item/paper_bin/carbon{
	pixel_y = 2;
	pixel_x = 6
	},
/obj/item/pen/fourcolor{
	pixel_x = 6;
	pixel_y = 2
	},
/turf/open/floor/iron/grimy,
/area/misc/condo)
"Be" = (
/obj/effect/turf_decal/siding/wood{
	dir = 4
	},
/obj/effect/turf_decal/siding/wood{
	dir = 8
	},
/turf/open/floor/wood,
/area/misc/condo)
"BG" = (
/obj/structure/table/wood,
/obj/item/papercutter{
	pixel_x = 4;
	pixel_y = 4
	},
/obj/item/storage/crayons{
	pixel_x = 1;
	pixel_y = -1
	},
/obj/item/storage/crayons{
	pixel_x = -2;
	pixel_y = -5
	},
/obj/item/wirecutters,
/turf/open/floor/carpet/blue,
/area/misc/condo)
"BQ" = (
/obj/effect/turf_decal/siding/wood{
	dir = 10
	},
/obj/effect/turf_decal/siding/wood/corner{
	dir = 4
	},
/turf/open/floor/wood,
/area/misc/condo)
"Cu" = (
/obj/effect/turf_decal/siding/wood{
	dir = 10
	},
/turf/open/floor/carpet/black,
/area/misc/condo)
"Dr" = (
/obj/structure/sign/painting/library{
	pixel_y = -32
	},
/obj/effect/turf_decal/siding/wood{
	dir = 1
	},
/obj/effect/turf_decal/siding/wood,
/turf/open/floor/wood,
/area/misc/condo)
"DG" = (
/obj/effect/turf_decal/siding/wood{
	dir = 1
	},
/obj/structure/chair/office,
/turf/open/floor/wood,
/area/misc/condo)
"DW" = (
/obj/item/kirbyplants/random,
/turf/open/floor/iron/grimy,
/area/misc/condo)
"Eu" = (
/obj/structure/table/wood,
/obj/effect/turf_decal/siding/wood{
	dir = 8
	},
/obj/effect/turf_decal/siding/wood{
	dir = 4
	},
/obj/item/pen/fountain,
/turf/open/floor/iron/grimy,
/area/misc/condo)
"Fg" = (
/obj/effect/turf_decal/siding/wood,
/turf/open/floor/wood,
/area/misc/condo)
"Fs" = (
/obj/machinery/vending/coffee{
	default_price = 0
	},
/turf/open/floor/carpet/red,
/area/misc/condo)
"FV" = (
/obj/machinery/door/airlock/wood,
/turf/open/floor/wood,
/area/misc/condo)
"GM" = (
/obj/structure/fireplace{
	pixel_y = 0;
	pixel_x = 0
	},
/obj/effect/turf_decal/siding/wood{
	dir = 1
	},
/obj/effect/turf_decal/siding/wood,
/obj/structure/chair/office,
/obj/machinery/light/small/dim/directional/north,
/turf/open/floor/wood,
/area/misc/condo)
"Ha" = (
/obj/structure/table/wood,
/obj/item/pen/fourcolor,
/turf/open/floor/wood,
/area/misc/condo)
"Hl" = (
/obj/machinery/libraryscanner,
/turf/open/floor/carpet/green,
/area/misc/condo)
"HI" = (
/obj/machinery/computer/libraryconsole/bookmanagement,
/obj/structure/table/wood,
/turf/open/floor/iron/grimy,
/area/misc/condo)
"Ig" = (
/obj/structure/chair/comfy/brown{
	dir = 4
	},
/obj/effect/turf_decal/siding/wood,
/turf/open/floor/wood,
/area/misc/condo)
"Ip" = (
/obj/structure/sign/painting/large/library{
	pixel_y = -37
	},
/obj/effect/turf_decal/siding/wood{
	dir = 1
	},
/obj/effect/turf_decal/siding/wood,
/turf/open/floor/wood,
/area/misc/condo)
"IO" = (
/obj/structure/table/wood/fancy,
/obj/effect/spawner/random/decoration/statue{
	spawn_loot_chance = 35
	},
/obj/structure/sign/painting/library{
	pixel_x = -32
	},
/obj/machinery/light/directional/south,
/turf/open/floor/wood,
/area/misc/condo)
"Kr" = (
/obj/structure/table/wood,
/obj/effect/turf_decal/siding/wood{
	dir = 9
	},
/obj/effect/turf_decal/siding/wood/corner,
/turf/open/floor/iron/grimy,
/area/misc/condo)
"NP" = (
/obj/structure/table/wood,
/obj/effect/turf_decal/siding/wood,
/obj/effect/turf_decal/siding/wood{
	dir = 1
	},
/obj/item/reagent_containers/cup/glass/coffee,
/turf/open/floor/wood,
/area/misc/condo)
"NR" = (
/obj/effect/turf_decal/siding/wood,
/obj/effect/turf_decal/siding/wood{
	dir = 1
	},
/turf/open/floor/wood,
/area/misc/condo)
"Oc" = (
/obj/structure/bookcase/random/adult,
/turf/open/floor/wood,
/area/misc/condo)
"OF" = (
/turf/open/floor/carpet/green,
/area/misc/condo)
"OT" = (
/obj/effect/turf_decal/siding/wood,
/obj/effect/turf_decal/siding/wood{
	dir = 1
	},
/obj/structure/sign/painting/large/library{
	dir = 1
	},
/obj/item/kirbyplants/random,
/turf/open/floor/wood,
/area/misc/condo)
"OY" = (
/obj/structure/table/wood,
/obj/effect/turf_decal/siding/wood/end,
/obj/item/paper_bin/carbon{
	pixel_x = -6
	},
/obj/item/paper_bin/carbon{
	pixel_x = 7
	},
/turf/open/floor/iron/grimy,
/area/misc/condo)
"RC" = (
/turf/open/floor/iron/sepia,
/area/misc/condo)
"Sm" = (
/obj/machinery/door/airlock/wood/glass,
/turf/open/floor/wood,
/area/misc/condo)
"Tr" = (
/obj/effect/turf_decal/siding/wood{
	dir = 8
	},
/turf/open/floor/wood,
/area/misc/condo)
"Tt" = (
/obj/structure/table/wood,
/obj/item/toy/crayon/spraycan{
	pixel_x = 4;
	pixel_y = 8
	},
/obj/item/chisel{
	pixel_x = -15;
	pixel_y = 6
	},
/obj/item/toy/crayon/spraycan{
	pixel_x = -4;
	pixel_y = 8
	},
/obj/item/toy/crayon/spraycan{
	pixel_y = 6
	},
/obj/item/paint_palette,
/turf/open/floor/carpet/blue,
/area/misc/condo)
"Uf" = (
/obj/structure/table/wood,
/obj/effect/turf_decal/siding/wood{
	dir = 1
	},
/obj/item/storage/dice{
	pixel_x = 8;
	pixel_y = 6
	},
/obj/item/storage/dice{
	pixel_x = -5;
	pixel_y = 6
	},
/turf/open/floor/carpet/black,
/area/misc/condo)
"Ug" = (
/obj/effect/turf_decal/siding/wood,
/obj/effect/turf_decal/siding/wood{
	dir = 1
	},
/obj/machinery/photocopier/gratis/infinite,
/turf/open/floor/wood,
/area/misc/condo)
"UW" = (
/obj/effect/turf_decal/siding/wood/end{
	dir = 4
	},
/turf/open/floor/wood,
/area/misc/condo)
"Vr" = (
/obj/structure/table/wood/fancy,
/obj/effect/spawner/random/decoration/statue{
	spawn_loot_chance = 35
	},
/obj/structure/sign/painting/library{
	pixel_x = -32
	},
/obj/machinery/light/directional/north,
/turf/open/floor/wood,
/area/misc/condo)
"Vu" = (
/obj/structure/chair/comfy/beige{
	dir = 8
	},
/obj/effect/turf_decal/siding/wood,
/obj/effect/turf_decal/siding/wood{
	dir = 1
	},
/turf/open/floor/wood,
/area/misc/condo)
"VC" = (
/obj/effect/turf_decal/siding/wood/end{
	dir = 8
	},
/obj/machinery/room_controller/directional/west,
/turf/open/floor/wood,
/area/misc/condo)
"WV" = (
/obj/effect/turf_decal/siding/wood{
	dir = 1
	},
/obj/effect/turf_decal/siding/wood,
/obj/structure/chair/office{
	dir = 1
	},
/obj/machinery/light/small/dim/directional/south,
/turf/open/floor/wood,
/area/misc/condo)
"YE" = (
/obj/machinery/bookbinder,
/obj/machinery/light/directional/south,
/turf/open/floor/carpet/red,
/area/misc/condo)
"Zu" = (
/turf/closed/indestructible/wood,
/area/misc/condo)
"ZJ" = (
/obj/effect/turf_decal/siding/wood,
/obj/effect/turf_decal/siding/wood{
	dir = 1
	},
/obj/structure/chair/office{
	dir = 1
	},
/turf/open/floor/wood,
/area/misc/condo)
"ZY" = (
/obj/effect/turf_decal/siding/wood{
	dir = 1
	},
/obj/effect/turf_decal/siding/wood,
/turf/open/floor/wood,
/area/misc/condo)

(1,1,1) = {"
bD
bD
bD
bD
Zu
Zu
vR
Zu
Zu
Zu
Zu
Zu
Zu
Zu
Zu
"}
(2,1,1) = {"
Zu
Zu
Zu
Zu
Zu
Fs
iB
YE
Zu
Zu
Vr
qm
qm
IO
Zu
"}
(3,1,1) = {"
Zu
Oc
ah
iS
VC
iB
iB
iB
id
Zu
sH
Be
Be
xW
Zu
"}
(4,1,1) = {"
Zu
Oc
ZY
iS
ZY
iB
gA
iB
NP
gT
kp
RC
lf
Ip
Zu
"}
(5,1,1) = {"
Zu
Oc
ZY
iS
ZY
iB
gA
iB
Vu
gT
Ug
RC
BG
ZY
Zu
"}
(6,1,1) = {"
Zu
HI
ZY
DW
ZY
iB
iB
iB
NR
Sm
NR
RC
Tt
Dr
Zu
"}
(7,1,1) = {"
Zu
tb
ZY
fR
yC
zQ
zQ
Tr
hv
Zu
OT
RC
RC
rv
Zu
"}
(8,1,1) = {"
Zu
Oc
ZY
iS
DG
gY
au
fQ
Ig
Zu
lt
lM
Be
AC
Zu
"}
(9,1,1) = {"
Zu
Oc
ZY
iS
DG
Ha
az
fQ
nD
Zu
Zu
Zu
FV
Zu
Zu
"}
(10,1,1) = {"
Zu
Oc
ZY
iS
ez
uK
uK
fQ
dG
Zu
tq
yl
Be
BQ
Zu
"}
(11,1,1) = {"
Zu
AK
ZY
fR
ez
fQ
fQ
fQ
Fg
FV
aD
dB
dB
rW
Zu
"}
(12,1,1) = {"
Zu
cC
ZY
DW
ez
Kr
tt
Eu
OY
Zu
GM
as
dB
WV
Zu
"}
(13,1,1) = {"
Zu
os
ZY
AJ
ez
nP
sC
OF
Hl
Zu
pN
dB
dB
ZJ
Zu
"}
(14,1,1) = {"
Zu
os
ZY
AJ
ez
kQ
OF
OF
yk
Zu
dE
ef
hu
Cu
Zu
"}
(15,1,1) = {"
Zu
os
UW
AJ
UW
Zu
Zu
Zu
Zu
Zu
Uf
tr
lz
le
Zu
"}
(16,1,1) = {"
Zu
Zu
Zu
Zu
Zu
Zu
bD
bD
bD
Zu
Zu
Zu
Zu
Zu
Zu
"}
