//MAP CONVERTED BY dmm2tgm.py THIS HEADER COMMENT PREVENTS RECONVERSION, DO NOT REMOVE
"br" = (
/turf/open/floor/light/colour_cycle/dancefloor_b,
/area/misc/condo)
"dD" = (
/obj/structure/railing{
	dir = 10
	},
/turf/open/floor/light/colour_cycle/dancefloor_b,
/area/misc/condo)
"ej" = (
/obj/structure/table/reinforced/plasmarglass,
/obj/machinery/reagentgrinder,
/turf/open/floor/light,
/area/misc/condo)
"er" = (
/obj/structure/table/wood/fancy/purple,
/obj/item/bdsm_candle{
	pixel_y = 6
	},
/turf/open/floor/light,
/area/misc/condo)
"eO" = (
/obj/structure/chair/sofa/corp/right{
	dir = 1
	},
/turf/open/floor/iron/dark,
/area/misc/condo)
"eX" = (
/obj/structure/railing{
	dir = 8
	},
/turf/open/floor/light/colour_cycle/dancefloor_b,
/area/misc/condo)
"ft" = (
/obj/structure/railing{
	dir = 8
	},
/turf/open/floor/light/colour_cycle,
/area/misc/condo)
"fw" = (
/obj/structure/table/reinforced/plasmarglass,
/obj/item/stack/spacecash/c1{
	pixel_x = -1;
	pixel_y = 3
	},
/turf/open/floor/light,
/area/misc/condo)
"gI" = (
/obj/structure/table/reinforced/plasmarglass,
/obj/item/rag{
	pixel_y = 3
	},
/obj/merge_conflict_marker{
	name = "---Merge Conflict Marker---";
	
	desc = "A best-effort merge was performed. You must resolve this conflict yourself (manually) and remove this object once complete."
	},
/obj/structure/table/reinforced/plasmarglass,
/turf/open/floor/light,
/area/misc/condo)
"gX" = (
/turf/open/floor/light/colour_cycle/dancefloor_a,
/area/misc/condo)
"hU" = (
/obj/structure/chair/stool/bar/directional/west,
/obj/structure/disposalpipe/junction{
	dir = 2
	},
/turf/open/floor/carpet/purple,
/area/misc/condo)
"in" = (
/obj/structure/chair/sofa/corp/corner{
	dir = 1
	},
/turf/open/floor/iron/dark,
/area/misc/condo)
"kh" = (
/obj/structure/chair/sofa/corp/right,
/turf/open/floor/iron/dark,
/area/misc/condo)
"kK" = (
/turf/open/floor/iron/stairs{
	dir = 8
	},
/area/misc/condo)
"kQ" = (
/obj/item/toy/plush/lizard_plushie/space,
/obj/machinery/light/dim/directional/north{
	alpha = 0
	},
/turf/open/floor/fakespace,
/area/misc/condo)
"lN" = (
/obj/structure/chair/sofa/corp/right{
	dir = 4
	},
/turf/open/floor/iron/dark,
/area/misc/condo)
"ml" = (
/obj/structure/chair/comfy/brown{
	color = "#596479";
	dir = 2
	},
/turf/open/floor/iron/dark,
/area/misc/condo)
"mZ" = (
/obj/structure/disposalpipe/segment,
/turf/open/floor/carpet/purple,
/area/misc/condo)
"nL" = (
/obj/structure/chair/comfy/brown{
	color = "#596479";
	dir = 1
	},
/turf/open/floor/iron/dark,
/area/misc/condo)
"nS" = (
/obj/structure/disposalpipe/segment{
	dir = 5
	},
/turf/open/floor/iron/dark,
/area/misc/condo)
"of" = (
/obj/structure/chair/sofa/corp/left,
/turf/open/floor/iron/dark,
/area/misc/condo)
"oo" = (
/obj/structure/table/reinforced/plasmarglass,
/obj/structure/stripper_pole,
/turf/open/floor/light,
/area/misc/condo)
"pb" = (
/obj/machinery/jukebox/disco{
	anchored = 1
	},
/turf/open/floor/light/colour_cycle/dancefloor_a,
/area/misc/condo)
"pz" = (
/obj/structure/railing{
	dir = 4
	},
/turf/open/floor/light/colour_cycle/dancefloor_b,
/area/misc/condo)
"pB" = (
/obj/structure/table/reinforced/plasmarglass,
/turf/open/floor/light,
/area/misc/condo)
"pN" = (
/obj/machinery/chem_dispenser/drinks/fullupgrade{
	pixel_y = 32
	},
/obj/structure/table/reinforced/plasmarglass,
/obj/item/soap/deluxe,
/turf/open/floor/light,
/area/misc/condo)
"ql" = (
/obj/structure/toilet{
	pixel_y = 13
	},
/turf/open/floor/iron/freezer,
/area/misc/condo)
"qz" = (
/obj/machinery/door/airlock/bathroom{
	name = "Restroom"
	},
/obj/structure/disposalpipe/segment{
	dir = 4
	},
/turf/open/floor/iron/dark,
/area/misc/condo)
"rC" = (
/obj/machinery/room_controller/directional/west,
/turf/open/floor/carpet/purple,
/area/misc/condo)
"rH" = (
/obj/structure/railing{
	dir = 1
	},
/turf/open/floor/iron/stairs{
	dir = 4
	},
/area/misc/condo)
"rU" = (
/obj/structure/disposalpipe/segment{
	dir = 4
	},
/turf/open/floor/iron/dark,
/area/misc/condo)
"sC" = (
/turf/closed/indestructible/steel,
/area/misc/condo)
"tw" = (
/obj/structure/table/reinforced,
/turf/open/floor/iron,
/area/misc/condo)
"tP" = (
/obj/structure/railing{
	dir = 9
	},
/turf/open/floor/light/colour_cycle/dancefloor_b,
/area/misc/condo)
"uP" = (
/obj/machinery/disposal/bin,
/obj/structure/disposalpipe/trunk{
	dir = 2
	},
/turf/open/floor/iron/dark,
/area/misc/condo)
"uS" = (
/obj/structure/table/reinforced,
/obj/machinery/jukebox,
/obj/structure/musician/piano/minimoog{
	pixel_x = 15
	},
/obj/structure/railing{
	dir = 8
	},
/turf/open/floor/light,
/area/misc/condo)
"uW" = (
/turf/open/floor/iron/stairs{
	dir = 1
	},
/area/misc/condo)
"vg" = (
/turf/open/floor/iron/dark,
/area/misc/condo)
"vX" = (
/obj/structure/railing{
	dir = 1
	},
/turf/open/floor/iron,
/area/misc/condo)
"ya" = (
/obj/machinery/light/dim/directional/west{
	alpha = 0
	},
/turf/open/floor/fakespace,
/area/misc/condo)
"zB" = (
/obj/structure/railing,
/turf/open/floor/light/colour_cycle,
/area/misc/condo)
"zK" = (
/obj/structure/chair/sofa/corp/corner{
	dir = 8
	},
/turf/open/floor/iron/dark,
/area/misc/condo)
"AB" = (
/obj/structure/chair/sofa/corp/left{
	dir = 1
	},
/turf/open/floor/iron/dark,
/area/misc/condo)
"Bp" = (
/obj/structure/railing{
	dir = 5
	},
/turf/open/floor/light/colour_cycle/dancefloor_b,
/area/misc/condo)
"Ct" = (
/obj/structure/sink/directional/west,
/obj/machinery/light/small/dim/directional/south,
/obj/machinery/dryer{
	dir = 8;
	pixel_x = 6;
	pixel_y = 17
	},
/obj/structure/disposalpipe/segment{
	dir = 10
	},
/turf/open/floor/iron/freezer,
/area/misc/condo)
"CT" = (
/turf/open/floor/iron,
/area/misc/condo)
"CY" = (
/obj/structure/chair/sofa/corp/left{
	dir = 4
	},
/turf/open/floor/iron/dark,
/area/misc/condo)
"DF" = (
/turf/open/floor/carpet/purple,
/area/misc/condo)
"DP" = (
/obj/structure/disposalpipe/segment,
/turf/closed/indestructible/steel,
/area/misc/condo)
"DZ" = (
/turf/closed/indestructible/hoteldoor/fakedoor,
/area/misc/condo)
"Eb" = (
/obj/item/food/syndicake,
/obj/item/food/syndicake,
/obj/item/food/syndicake,
/obj/item/food/syndicake,
/obj/item/food/syndicake,
/obj/item/food/syndicake,
/obj/item/food/syndicake,
/obj/structure/closet/crate/freezer,
/obj/item/toy/crayon/spraycan,
/turf/open/floor/iron/dark,
/area/misc/condo)
"EW" = (
/turf/open/floor/iron/stairs,
/area/misc/condo)
"EX" = (
/obj/machinery/barsign/all_access,
/turf/closed/indestructible/steel,
/area/misc/condo)
"FE" = (
/obj/structure/railing{
	dir = 4
	},
/turf/open/floor/light/colour_cycle,
/area/misc/condo)
"FK" = (
/obj/machinery/vending/dorms,
/turf/open/floor/light,
/area/misc/condo)
"HO" = (
/obj/structure/table/reinforced,
/obj/structure/railing{
	dir = 10
	},
/turf/open/floor/light,
/area/misc/condo)
"HU" = (
/turf/closed/wall/space{
	space_lit = 1
	},
/area/misc/condo)
"IM" = (
/obj/structure/table/reinforced,
/obj/item/toy/crayon/spraycan,
/turf/open/floor/iron,
/area/misc/condo)
"IW" = (
/obj/structure/table/reinforced/plasmarglass,
/obj/structure/disposalpipe/segment{
	dir = 4
	},
/turf/open/floor/light,
/area/misc/condo)
"Ju" = (
/obj/machinery/light/directional/west,
/obj/machinery/disposal/bin,
/obj/structure/disposalpipe/trunk{
	dir = 2
	},
/obj/item/wrench,
/turf/open/floor/carpet/purple,
/area/misc/condo)
"KZ" = (
/obj/structure/table/reinforced,
/obj/item/instrument/piano_synth,
/obj/item/instrument/eguitar,
/obj/item/instrument/saxophone,
/turf/open/floor/iron/dark,
/area/misc/condo)
"Lb" = (
/obj/structure/railing{
	dir = 6
	},
/turf/open/floor/light/colour_cycle/dancefloor_b,
/area/misc/condo)
"MK" = (
/obj/structure/railing{
	dir = 1
	},
/turf/open/floor/light/colour_cycle,
/area/misc/condo)
"OW" = (
/obj/structure/table/reinforced/plasmarglass,
/obj/item/stack/spacecash/c10{
	pixel_x = -6;
	pixel_y = 8
	},
/turf/open/floor/light,
/area/misc/condo)
"Pr" = (
/obj/structure/table/reinforced/plasmarglass,
/obj/item/stack/spacecash/c1{
	pixel_x = -9;
	pixel_y = 1
	},
/turf/open/floor/light,
/area/misc/condo)
"Pt" = (
/obj/structure/railing,
/turf/open/floor/light/colour_cycle/dancefloor_b,
/area/misc/condo)
"QO" = (
/obj/machinery/chem_dispenser/drinks/beer/fullupgrade{
	pixel_y = 32
	},
/obj/structure/table/reinforced/plasmarglass,
/obj/item/rag,
/turf/open/floor/light,
/area/misc/condo)
"QU" = (
/obj/structure/table/reinforced/plasmarglass,
/obj/item/stack/spacecash/c1{
	pixel_x = -6;
	pixel_y = 3
	},
/obj/item/stack/spacecash/c10{
	pixel_x = 6;
	pixel_y = 10
	},
/turf/open/floor/light,
/area/misc/condo)
"Ro" = (
/obj/structure/chair/sofa/corp/right{
	dir = 8
	},
/obj/item/clothing/sextoy/condom,
/turf/open/floor/iron/dark,
/area/misc/condo)
"St" = (
/obj/structure/chair/sofa/corp/corner,
/turf/open/floor/iron/dark,
/area/misc/condo)
"Tk" = (
/turf/open/floor/fakespace,
/area/misc/condo)
"TE" = (
/obj/structure/chair/comfy/brown{
	color = "#596479";
	dir = 8
	},
/turf/open/floor/iron/dark,
/area/misc/condo)
"UX" = (
/obj/structure/chair/stool/bar/directional/north,
/turf/open/floor/carpet/purple,
/area/misc/condo)
"VX" = (
/obj/structure/disposalpipe/trunk{
	dir = 1
	},
/turf/closed/indestructible/steel,
/area/misc/condo)
"Wc" = (
/obj/machinery/vending/boozeomat{
	pixel_y = 32
	},
/obj/structure/table/reinforced/plasmarglass,
/obj/item/reagent_containers/cup/glass/shaker{
	pixel_x = 4
	},
/turf/open/floor/light,
/area/misc/condo)
"WU" = (
/obj/structure/chair/stool/bar/directional/west,
/obj/structure/disposalpipe/segment,
/turf/open/floor/carpet/purple,
/area/misc/condo)
"Xi" = (
/obj/structure/table/reinforced/plasmarglass,
/obj/item/stack/spacecash/c1{
	pixel_x = 8;
	pixel_y = -6
	},
/obj/item/stack/spacecash/c10{
	pixel_x = 0;
	pixel_y = -13
	},
/turf/open/floor/light,
/area/misc/condo)
"XB" = (
/obj/machinery/door/airlock/grunge,
/turf/open/floor/iron/dark,
/area/misc/condo)
"XN" = (
/obj/structure/railing{
	dir = 1
	},
/turf/open/floor/iron/stairs{
	dir = 8;
	initial_gas_mix = "TEMP=2.7"
	},
/area/misc/condo)
"XQ" = (
/obj/structure/table/reinforced,
/obj/structure/railing{
	dir = 9
	},
/turf/open/floor/light,
/area/misc/condo)
"Yr" = (
/turf/open/floor/light/colour_cycle,
/area/misc/condo)
"Yt" = (
/obj/structure/table/reinforced/plasmarglass,
/obj/item/storage/box/drinkingglasses,
/turf/open/floor/light,
/area/misc/condo)
"YK" = (
/obj/structure/chair/sofa/corp/corner{
	dir = 4
	},
/turf/open/floor/iron/dark,
/area/misc/condo)
"YL" = (
/obj/structure/chair/sofa/corp/left{
	dir = 8
	},
/turf/open/floor/iron/dark,
/area/misc/condo)
"YQ" = (
/obj/structure/table/reinforced/plasmarglass,
/obj/item/stack/spacecash/c1{
	pixel_x = 4;
	pixel_y = 15
	},
/turf/open/floor/light,
/area/misc/condo)

(1,1,1) = {"
sC
sC
sC
sC
sC
sC
DZ
sC
sC
sC
sC
sC
sC
sC
sC
"}
(2,1,1) = {"
sC
pB
pN
vg
vg
sC
DF
rC
ml
er
nL
ml
er
nL
sC
"}
(3,1,1) = {"
sC
pB
QO
vg
vg
XB
DF
DF
vg
TE
vg
vg
TE
vg
sC
"}
(4,1,1) = {"
sC
pB
Wc
vg
vg
pB
UX
DF
vg
vg
vg
vg
vg
vg
sC
"}
(5,1,1) = {"
sC
ej
Yt
vg
vg
gI
UX
DF
vg
tP
ft
eX
ft
dD
sC
"}
(6,1,1) = {"
sC
Eb
vg
vg
vg
pB
UX
DF
XN
MK
gX
Yr
gX
zB
sC
"}
(7,1,1) = {"
sC
uP
nS
vg
vg
pB
UX
DF
vX
br
Yr
pb
Yr
Pt
sC
"}
(8,1,1) = {"
sC
sC
IW
pB
pB
EX
DF
DF
rH
MK
gX
Yr
gX
zB
sC
"}
(9,1,1) = {"
sC
Ju
hU
WU
WU
DP
mZ
mZ
nS
Bp
FE
pz
FE
Lb
sC
"}
(10,1,1) = {"
sC
DF
DF
DF
DF
DF
DF
DF
rU
vg
vg
vg
vg
vg
sC
"}
(11,1,1) = {"
sC
YK
lN
kK
CY
in
vg
vg
rU
vg
XQ
uS
HO
vg
sC
"}
(12,1,1) = {"
sC
of
Xi
fw
pB
eO
vg
vg
rU
uW
CT
CT
CT
EW
sC
"}
(13,1,1) = {"
sC
vg
pB
oo
QU
vg
vg
FK
rU
sC
KZ
tw
IM
sC
sC
"}
(14,1,1) = {"
sC
kh
Pr
OW
YQ
AB
sC
sC
qz
sC
sC
sC
sC
sC
HU
"}
(15,1,1) = {"
sC
St
YL
vg
Ro
zK
sC
ql
Ct
VX
kQ
Tk
Tk
ya
HU
"}
(16,1,1) = {"
sC
sC
sC
sC
sC
sC
sC
sC
sC
sC
HU
HU
HU
HU
HU
"}
