//MAP CONVERTED BY dmm2tgm.py THIS HEADER COMMENT PREVENTS RECONVERSION, DO NOT REMOVE
"ab" = (
/obj/structure/fluff/beach_umbrella/engine{
	pixel_x = 11;
	pixel_y = 9
	},
/obj/effect/light_emitter/interlink{
	light_color = "#2e2e2e"
	},
/turf/open/misc/beach/sand,
/area/misc/condo)
"ai" = (
/obj/structure/closet/mini_fridge,
/obj/structure/table/wood,
/obj/item/pizzabox/pineapple,
/obj/item/storage/cans/sixbeer,
/obj/machinery/light/warm/directional/east,
/turf/open/floor/iron/terracotta,
/area/misc/condo)
"av" = (
/turf/closed/indestructible/sandstone,
/area/misc/condo)
"aA" = (
/obj/structure/flora/coconuts{
	pixel_y = 15
	},
/turf/open/floor/grass,
/area/misc/condo)
"aB" = (
/obj/structure/flora/bush/jungle/a/style_random,
/obj/effect/light_emitter/interlink{
	light_color = "#2e2e2e"
	},
/turf/open/floor/grass,
/area/misc/condo)
"ci" = (
/obj/effect/light_emitter/interlink{
	light_color = "#2e2e2e"
	},
/turf/open/misc/beach/sand,
/area/misc/condo)
"cH" = (
/obj/structure/table/wood,
/obj/item/flashlight/flare/candle/infinite,
/turf/open/floor/iron/terracotta,
/area/misc/condo)
"dd" = (
/obj/structure/flora/tree/palm{
	pixel_y = 11;
	density = 0
	},
/obj/effect/turf_decal/weather/sand{
	dir = 10
	},
/obj/structure/flora/coconuts{
	pixel_y = 7
	},
/turf/open/floor/grass,
/area/misc/condo)
"dj" = (
/obj/structure/flora/tree/palm{
	pixel_y = -9;
	density = 0
	},
/obj/effect/turf_decal/weather/sand{
	dir = 5
	},
/turf/open/floor/grass,
/area/misc/condo)
"ds" = (
/obj/structure/flora/tree/palm/style_2{
	density = 0
	},
/turf/open/floor/grass,
/area/misc/condo)
"ea" = (
/obj/structure/flora/bush/jungle/a/style_random,
/turf/open/misc/beach/sand,
/area/misc/condo)
"ez" = (
/obj/structure/flora/tree/palm/style_2{
	density = 0
	},
/turf/open/misc/beach/sand,
/area/misc/condo)
"eH" = (
/turf/closed/indestructible/hoteldoor/fakedoor,
/area/misc/condo)
"fw" = (
/obj/structure/chair/wood{
	dir = 4
	},
/turf/open/floor/iron/terracotta,
/area/misc/condo)
"fI" = (
/obj/machinery/room_controller/directional/west,
/turf/open/misc/beach/sand,
/area/misc/condo)
"jV" = (
/turf/open/floor/carpet/orange,
/area/misc/condo)
"kg" = (
/obj/effect/turf_decal/weather/sand{
	dir = 6
	},
/obj/effect/turf_decal/weather/sand{
	dir = 8
	},
/turf/open/floor/grass,
/area/misc/condo)
"kG" = (
/turf/closed/indestructible/rock,
/area/misc/condo)
"mp" = (
/obj/effect/turf_decal/weather/sand{
	dir = 10
	},
/turf/open/floor/grass,
/area/misc/condo)
"mC" = (
/obj/structure/flora/tree/palm{
	density = 0
	},
/obj/effect/turf_decal/weather/sand{
	dir = 5
	},
/obj/structure/flora/coconuts{
	pixel_y = -6
	},
/turf/open/floor/grass,
/area/misc/condo)
"mK" = (
/obj/effect/turf_decal/weather/sand{
	dir = 9
	},
/turf/open/water{
	icon_state = "pool_1"
	},
/area/misc/condo)
"ok" = (
/obj/effect/light_emitter/interlink{
	light_color = "#2e2e2e"
	},
/turf/open/water{
	icon_state = "pool_1"
	},
/area/misc/condo)
"oQ" = (
/obj/structure/bed/double{
	dir = 4
	},
/obj/effect/spawner/random/bedsheet/double{
	dir = 4
	},
/turf/open/floor/iron/terracotta,
/area/misc/condo)
"pS" = (
/obj/effect/turf_decal/weather/sand{
	dir = 1;
	pixel_y = 1
	},
/obj/structure/flora/rock/pile/jungle/style_random,
/turf/open/floor/grass,
/area/misc/condo)
"qu" = (
/obj/effect/turf_decal/weather/sand{
	dir = 6
	},
/turf/open/water{
	icon_state = "pool_1"
	},
/area/misc/condo)
"uB" = (
/obj/structure/flora/tree/palm/style_2{
	pixel_y = 14;
	density = 0
	},
/obj/effect/turf_decal/weather/sand{
	dir = 10
	},
/turf/open/floor/grass,
/area/misc/condo)
"uC" = (
/obj/effect/turf_decal/weather/sand{
	dir = 8
	},
/turf/open/water{
	icon_state = "pool_1"
	},
/area/misc/condo)
"uV" = (
/obj/structure/flora/tree/palm{
	density = 0
	},
/turf/open/misc/beach/sand,
/area/misc/condo)
"vo" = (
/obj/effect/turf_decal/weather/sand{
	dir = 10
	},
/obj/structure/flora/bush/fullgrass/style_random,
/turf/open/floor/grass,
/area/misc/condo)
"vr" = (
/obj/effect/turf_decal/weather/sand{
	dir = 5
	},
/turf/open/water{
	icon_state = "pool_1"
	},
/area/misc/condo)
"vS" = (
/turf/open/misc/beach/sand,
/area/misc/condo)
"vU" = (
/obj/machinery/light/small/dim/directional/east,
/turf/open/misc/beach/sand,
/area/misc/condo)
"wE" = (
/obj/structure/chair/wood{
	dir = 8
	},
/turf/open/floor/iron/terracotta,
/area/misc/condo)
"xD" = (
/obj/structure/flora/bush/fullgrass/style_random,
/obj/effect/light_emitter/interlink{
	light_color = "#2e2e2e"
	},
/turf/open/floor/grass,
/area/misc/condo)
"zx" = (
/obj/structure/flora/bush/fullgrass/style_random,
/turf/open/misc/beach/sand,
/area/misc/condo)
"Ar" = (
/obj/structure/flora/bush/sparsegrass/style_random,
/turf/open/misc/beach/sand,
/area/misc/condo)
"AK" = (
/obj/machinery/door/airlock/sandstone,
/turf/open/floor/iron/terracotta,
/area/misc/condo)
"Cj" = (
/obj/structure/flora/bush/fullgrass/style_random,
/obj/effect/light_emitter/interlink{
	light_color = "#2e2e2e"
	},
/turf/open/misc/beach/sand,
/area/misc/condo)
"Cp" = (
/obj/effect/turf_decal/weather/sand{
	dir = 8
	},
/obj/effect/turf_decal/weather/sand{
	dir = 4
	},
/turf/open/floor/grass,
/area/misc/condo)
"EH" = (
/obj/effect/turf_decal/weather/sand{
	dir = 10
	},
/turf/open/water{
	icon_state = "pool_1"
	},
/area/misc/condo)
"EI" = (
/obj/structure/flora/bush/large/style_random,
/turf/open/misc/beach/sand,
/area/misc/condo)
"FA" = (
/obj/structure/flora/bush/jungle/b/style_random,
/obj/effect/light_emitter/interlink{
	light_color = "#2e2e2e"
	},
/turf/open/misc/beach/sand,
/area/misc/condo)
"He" = (
/obj/effect/turf_decal/weather/sand,
/turf/open/floor/grass,
/area/misc/condo)
"HH" = (
/obj/structure/table/wood,
/obj/item/storage/cans/sixbeer,
/obj/item/toy/plush/lizard_plushie,
/turf/open/floor/iron/terracotta,
/area/misc/condo)
"HM" = (
/obj/item/kirbyplants/random,
/obj/machinery/light_switch/directional/west,
/turf/open/floor/iron/terracotta,
/area/misc/condo)
"HX" = (
/obj/effect/turf_decal/weather/sand{
	dir = 6
	},
/obj/structure/flora/bush/jungle/a/style_random,
/obj/effect/light_emitter/interlink{
	light_color = "#2e2e2e"
	},
/turf/open/floor/grass,
/area/misc/condo)
"IV" = (
/obj/machinery/light_switch/directional/north,
/turf/open/floor/iron/terracotta,
/area/misc/condo)
"KU" = (
/turf/open/water{
	icon_state = "pool_1"
	},
/area/misc/condo)
"KY" = (
/obj/effect/turf_decal/weather/sand{
	dir = 6
	},
/turf/open/floor/grass,
/area/misc/condo)
"LA" = (
/obj/effect/turf_decal/weather/sand{
	dir = 9
	},
/obj/structure/flora/bush/jungle/b/style_random,
/turf/open/floor/grass,
/area/misc/condo)
"MW" = (
/obj/structure/flora/bush/sparsegrass/style_random,
/obj/effect/light_emitter/interlink{
	light_color = "#2e2e2e"
	},
/turf/open/misc/beach/sand,
/area/misc/condo)
"Nr" = (
/obj/structure/flora/tree/palm{
	pixel_x = 8;
	pixel_y = 4;
	density = 0
	},
/obj/effect/turf_decal/weather/sand{
	dir = 9
	},
/obj/structure/flora/coconuts{
	pixel_y = -3;
	pixel_x = 5
	},
/turf/open/floor/grass,
/area/misc/condo)
"NC" = (
/obj/effect/turf_decal/weather/sand{
	dir = 6
	},
/obj/structure/flora/bush/jungle/a/style_random,
/turf/open/floor/grass,
/area/misc/condo)
"Pv" = (
/obj/structure/flora/tree/palm/style_2{
	pixel_y = 0;
	density = 0
	},
/obj/effect/turf_decal/weather/sand{
	dir = 1;
	pixel_y = 1
	},
/obj/structure/flora/coconuts{
	pixel_y = -7;
	pixel_x = 4
	},
/turf/open/floor/grass,
/area/misc/condo)
"QQ" = (
/obj/effect/turf_decal/weather/sand{
	dir = 8
	},
/obj/structure/flora/bush/fullgrass/style_random,
/turf/open/floor/grass,
/area/misc/condo)
"Rp" = (
/obj/structure/flora/rock/pile/jungle/style_random,
/turf/open/floor/grass,
/area/misc/condo)
"RY" = (
/obj/effect/turf_decal/weather/sand{
	dir = 5
	},
/obj/structure/flora/bush/jungle/c/style_random,
/turf/open/floor/grass,
/area/misc/condo)
"TE" = (
/obj/structure/curtain/cloth/fancy,
/turf/closed/indestructible/fakeglass,
/area/misc/condo)
"Ud" = (
/turf/closed/indestructible/hoteldoor{
	icon_state = "door_closed";
	icon = 'icons/obj/doors/puzzledoor/default.dmi'
	},
/area/misc/condo)
"UX" = (
/turf/open/floor/iron/terracotta,
/area/misc/condo)
"VX" = (
/obj/machinery/light/warm/directional/east,
/turf/open/floor/iron/terracotta,
/area/misc/condo)
"WN" = (
/obj/effect/turf_decal/weather/sand{
	dir = 9
	},
/obj/structure/flora/bush/jungle/b/style_random,
/obj/effect/light_emitter/interlink{
	light_color = "#2e2e2e"
	},
/turf/open/floor/grass,
/area/misc/condo)
"WR" = (
/turf/open/floor/carpet/purple,
/area/misc/condo)
"XR" = (
/obj/effect/turf_decal/weather/sand{
	dir = 9
	},
/obj/structure/flora/rock/pile/jungle/style_random,
/turf/open/floor/grass,
/area/misc/condo)
"Yh" = (
/obj/structure/flora/tree/palm{
	density = 0
	},
/obj/structure/flora/coconuts{
	pixel_y = -5;
	pixel_x = 3
	},
/turf/open/misc/beach/sand,
/area/misc/condo)
"Yv" = (
/obj/structure/dresser{
	pixel_y = 4
	},
/turf/open/floor/iron/terracotta,
/area/misc/condo)
"YQ" = (
/obj/structure/flora/tree/palm/style_2{
	density = 0
	},
/obj/structure/flora/coconuts{
	pixel_y = -5;
	pixel_x = 3
	},
/turf/open/misc/beach/sand,
/area/misc/condo)
"ZB" = (
/obj/effect/turf_decal/weather/sand{
	dir = 6
	},
/obj/structure/flora/bush/jungle/c/style_random,
/turf/open/floor/grass,
/area/misc/condo)

(1,1,1) = {"
kG
kG
kG
kG
kG
kG
kG
eH
kG
kG
kG
kG
kG
kG
kG
"}
(2,1,1) = {"
kG
kG
vS
YQ
vS
vS
fI
zx
vS
vS
vS
vS
ez
kG
kG
"}
(3,1,1) = {"
kG
Ar
vS
ci
zx
vS
FA
vS
vS
WN
uB
zx
ci
EI
kG
"}
(4,1,1) = {"
kG
vS
EI
vS
Nr
Cp
mK
uC
KU
EH
RY
dd
vS
vS
kG
"}
(5,1,1) = {"
kG
Yh
zx
XR
ZB
mK
KU
KU
KU
KU
EH
pS
vo
vS
kG
"}
(6,1,1) = {"
kG
vS
LA
xD
mK
KU
ok
KU
KU
ok
KU
Pv
HX
vS
kG
"}
(7,1,1) = {"
kG
vS
ds
He
KU
KU
KU
KU
KU
KU
qu
NC
vS
vS
kG
"}
(8,1,1) = {"
kG
vS
dj
aA
vr
KU
KU
KU
KU
qu
Ar
vS
EI
vS
kG
"}
(9,1,1) = {"
kG
vS
zx
aB
mp
vr
ok
KU
qu
Cj
vS
vS
ci
Ar
kG
"}
(10,1,1) = {"
kG
vS
vS
mC
Rp
QQ
kg
vS
vS
ea
vS
vS
vS
Yh
kG
"}
(11,1,1) = {"
kG
YQ
vS
zx
RY
KY
zx
vS
vS
vS
vU
av
TE
av
av
"}
(12,1,1) = {"
kG
vS
vS
ab
vS
EI
ci
av
av
AK
av
av
HH
Yv
av
"}
(13,1,1) = {"
kG
vS
vS
jV
Ar
vS
vS
av
fw
WR
HM
av
IV
oQ
av
"}
(14,1,1) = {"
kG
vS
uV
jV
vS
vS
vS
TE
cH
UX
UX
AK
UX
VX
av
"}
(15,1,1) = {"
kG
kG
vS
ci
vS
Yh
MW
av
wE
UX
ai
av
av
av
av
"}
(16,1,1) = {"
kG
kG
kG
kG
kG
kG
kG
av
av
Ud
av
av
kG
kG
kG
"}
