//MAP CONVERTED BY dmm2tgm.py THIS HEADER COMMENT PREVENTS RECONVERSION, DO NOT REMOVE
"ap" = (
/obj/effect/light_emitter/interlink,
/turf/open/floor/carpet/orange,
/area/misc/condo)
"aL" = (
/obj/machinery/door/airlock/sandstone,
/turf/open/floor/iron/terracotta,
/area/misc/condo)
"aT" = (
/obj/structure/closet/mini_fridge,
/obj/structure/table/wood,
/obj/item/pizzabox/pineapple,
/obj/item/storage/cans/sixbeer,
/obj/machinery/light/warm/directional/east,
/turf/open/floor/iron/terracotta,
/area/misc/condo)
"aY" = (
/obj/structure/flora/tree/palm/style_2{
	pixel_y = 14;
	density = 0
	},
/obj/effect/turf_decal/weather/sand{
	dir = 10
	},
/obj/effect/light_emitter/interlink,
/turf/open/floor/grass,
/area/misc/condo)
"bM" = (
/obj/structure/flora/bush/large/style_random,
/turf/open/misc/beach/sand,
/area/misc/condo)
"cn" = (
/obj/machinery/light_switch/directional/north,
/turf/open/floor/iron/terracotta,
/area/misc/condo)
"df" = (
/turf/open/floor/iron/terracotta,
/area/misc/condo)
"dj" = (
/obj/effect/light_emitter/interlink,
/turf/open/misc/beach/sand,
/area/misc/condo)
"dD" = (
/obj/structure/flora/rock/pile/jungle/style_random,
/obj/effect/light_emitter/interlink,
/turf/open/floor/grass,
/area/misc/condo)
"eo" = (
/obj/structure/flora/bush/fullgrass/style_random,
/obj/effect/light_emitter/interlink,
/turf/open/misc/beach/sand,
/area/misc/condo)
"fL" = (
/obj/effect/turf_decal/weather/sand{
	dir = 9
	},
/obj/effect/light_emitter/interlink,
/turf/open/water{
	icon_state = "pool_1"
	},
/area/misc/condo)
"hX" = (
/obj/structure/flora/tree/palm/style_2{
	density = 0
	},
/obj/structure/flora/coconuts{
	pixel_y = -5;
	pixel_x = 3
	},
/turf/open/misc/beach/sand,
/area/misc/condo)
"if" = (
/obj/structure/flora/bush/jungle/a/style_random,
/obj/effect/light_emitter/interlink,
/turf/open/misc/beach/sand,
/area/misc/condo)
"iu" = (
/obj/structure/curtain/cloth/fancy,
/turf/closed/indestructible/fakeglass,
/area/misc/condo)
"iv" = (
/obj/item/kirbyplants/random,
/obj/machinery/light_switch/directional/west,
/turf/open/floor/iron/terracotta,
/area/misc/condo)
"jN" = (
/obj/structure/flora/tree/palm/style_2{
	density = 0
	},
/turf/open/misc/beach/sand,
/area/misc/condo)
"kp" = (
/obj/structure/flora/tree/palm{
	pixel_y = -9;
	density = 0
	},
/obj/effect/turf_decal/weather/sand{
	dir = 5
	},
/obj/effect/light_emitter/interlink,
/turf/open/floor/grass,
/area/misc/condo)
"nk" = (
/obj/effect/turf_decal/weather/sand{
	dir = 8
	},
/obj/effect/turf_decal/weather/sand{
	dir = 4
	},
/obj/effect/light_emitter/interlink,
/turf/open/floor/grass,
/area/misc/condo)
"nU" = (
/obj/effect/turf_decal/weather/sand{
	dir = 6
	},
/obj/structure/flora/bush/jungle/c/style_random,
/obj/effect/light_emitter/interlink,
/turf/open/floor/grass,
/area/misc/condo)
"oK" = (
/obj/structure/flora/bush/fullgrass/style_random,
/turf/open/misc/beach/sand,
/area/misc/condo)
"pd" = (
/obj/structure/chair/wood{
	dir = 4
	},
/turf/open/floor/iron/terracotta,
/area/misc/condo)
"pt" = (
/obj/effect/turf_decal/weather/sand{
	dir = 6
	},
/obj/effect/light_emitter/interlink,
/turf/open/water{
	icon_state = "pool_1"
	},
/area/misc/condo)
"pK" = (
/obj/structure/flora/bush/fullgrass/style_random,
/obj/effect/light_emitter/interlink,
/turf/open/floor/grass,
/area/misc/condo)
"qq" = (
/obj/structure/flora/tree/palm{
	density = 0
	},
/obj/effect/turf_decal/weather/sand{
	dir = 5
	},
/obj/structure/flora/coconuts{
	pixel_y = -6
	},
/obj/effect/light_emitter/interlink,
/turf/open/floor/grass,
/area/misc/condo)
"qG" = (
/obj/structure/chair/wood{
	dir = 8
	},
/turf/open/floor/iron/terracotta,
/area/misc/condo)
"rf" = (
/obj/effect/turf_decal/weather/sand{
	dir = 8
	},
/obj/effect/light_emitter/interlink,
/turf/open/water{
	icon_state = "pool_1"
	},
/area/misc/condo)
"rz" = (
/obj/machinery/light/small/dim/directional/east,
/turf/open/misc/beach/sand,
/area/misc/condo)
"sB" = (
/obj/structure/flora/bush/sparsegrass/style_random,
/obj/effect/light_emitter/interlink,
/turf/open/misc/beach/sand,
/area/misc/condo)
"sU" = (
/obj/structure/flora/coconuts{
	pixel_y = 15
	},
/obj/effect/light_emitter/interlink,
/turf/open/floor/grass,
/area/misc/condo)
"tQ" = (
/obj/structure/bed/double{
	dir = 4
	},
/obj/effect/spawner/random/bedsheet/double{
	dir = 4
	},
/turf/open/floor/iron/terracotta,
/area/misc/condo)
"ud" = (
/obj/effect/turf_decal/weather/sand{
	dir = 9
	},
/obj/structure/flora/rock/pile/jungle/style_random,
/obj/effect/light_emitter/interlink,
/turf/open/floor/grass,
/area/misc/condo)
"uY" = (
/turf/closed/indestructible/sandstone,
/area/misc/condo)
"xs" = (
/turf/closed/indestructible/rock,
/area/misc/condo)
"yh" = (
/obj/effect/turf_decal/weather/sand{
	dir = 10
	},
/obj/effect/light_emitter/interlink,
/turf/open/water{
	icon_state = "pool_1"
	},
/area/misc/condo)
"yt" = (
/turf/open/floor/carpet/purple,
/area/misc/condo)
"za" = (
/obj/structure/flora/tree/palm{
	density = 0
	},
/obj/structure/flora/coconuts{
	pixel_y = -5;
	pixel_x = 3
	},
/turf/open/misc/beach/sand,
/area/misc/condo)
"zO" = (
/obj/effect/turf_decal/weather/sand,
/obj/effect/light_emitter/interlink,
/turf/open/floor/grass,
/area/misc/condo)
"AF" = (
/obj/structure/flora/tree/palm{
	density = 0
	},
/turf/open/misc/beach/sand,
/area/misc/condo)
"AM" = (
/obj/structure/flora/bush/jungle/b/style_random,
/obj/effect/light_emitter/interlink,
/turf/open/misc/beach/sand,
/area/misc/condo)
"AU" = (
/obj/structure/dresser{
	pixel_y = 4
	},
/turf/open/floor/iron/terracotta,
/area/misc/condo)
"Bc" = (
/obj/effect/turf_decal/weather/sand{
	dir = 10
	},
/obj/structure/flora/bush/fullgrass/style_random,
/obj/effect/light_emitter/interlink,
/turf/open/floor/grass,
/area/misc/condo)
"CO" = (
/obj/structure/fluff/beach_umbrella/engine{
	pixel_x = 11;
	pixel_y = 9
	},
/obj/effect/light_emitter/interlink,
/turf/open/misc/beach/sand,
/area/misc/condo)
"Ds" = (
/turf/closed/indestructible/hoteldoor/fakedoor,
/area/misc/condo)
"DE" = (
/obj/effect/turf_decal/weather/sand{
	dir = 1;
	pixel_y = 1
	},
/obj/structure/flora/rock/pile/jungle/style_random,
/obj/effect/light_emitter/interlink,
/turf/open/floor/grass,
/area/misc/condo)
"DT" = (
/obj/structure/table/wood,
/obj/item/storage/cans/sixbeer,
/obj/item/toy/plush/lizard_plushie,
/turf/open/floor/iron/terracotta,
/area/misc/condo)
"En" = (
/obj/effect/turf_decal/weather/sand{
	dir = 6
	},
/obj/effect/light_emitter/interlink,
/turf/open/floor/grass,
/area/misc/condo)
"EF" = (
/obj/structure/flora/bush/large/style_random,
/obj/effect/light_emitter/interlink,
/turf/open/misc/beach/sand,
/area/misc/condo)
"FI" = (
/obj/structure/table/wood,
/obj/item/flashlight/flare/candle/infinite,
/turf/open/floor/iron/terracotta,
/area/misc/condo)
"Hx" = (
/obj/structure/flora/tree/palm{
	pixel_x = 8;
	pixel_y = 4;
	density = 0
	},
/obj/effect/turf_decal/weather/sand{
	dir = 9
	},
/obj/structure/flora/coconuts{
	pixel_y = -3;
	pixel_x = 5
	},
/obj/effect/light_emitter/interlink,
/turf/open/floor/grass,
/area/misc/condo)
"HP" = (
/obj/effect/light_emitter/interlink,
/turf/open/water{
	icon_state = "pool_1"
	},
/area/misc/condo)
"LH" = (
/obj/structure/flora/tree/palm/style_2{
	pixel_y = 0;
	density = 0
	},
/obj/effect/turf_decal/weather/sand{
	dir = 1;
	pixel_y = 1
	},
/obj/structure/flora/coconuts{
	pixel_y = -7;
	pixel_x = 4
	},
/obj/effect/light_emitter/interlink,
/turf/open/floor/grass,
/area/misc/condo)
"Nb" = (
/obj/structure/flora/tree/palm{
	pixel_y = 11;
	density = 0
	},
/obj/effect/turf_decal/weather/sand{
	dir = 10
	},
/obj/structure/flora/coconuts{
	pixel_y = 7
	},
/obj/effect/light_emitter/interlink,
/turf/open/floor/grass,
/area/misc/condo)
"Pm" = (
/obj/effect/turf_decal/weather/sand{
	dir = 10
	},
/obj/effect/light_emitter/interlink,
/turf/open/floor/grass,
/area/misc/condo)
"Pw" = (
/obj/effect/turf_decal/weather/sand{
	dir = 6
	},
/obj/effect/turf_decal/weather/sand{
	dir = 8
	},
/obj/effect/light_emitter/interlink,
/turf/open/floor/grass,
/area/misc/condo)
"PJ" = (
/obj/structure/flora/bush/jungle/a/style_random,
/obj/effect/light_emitter/interlink,
/turf/open/floor/grass,
/area/misc/condo)
"PT" = (
/obj/effect/turf_decal/weather/sand{
	dir = 9
	},
/obj/structure/flora/bush/jungle/b/style_random,
/obj/effect/light_emitter/interlink,
/turf/open/floor/grass,
/area/misc/condo)
"QF" = (
/turf/open/misc/beach/sand,
/area/misc/condo)
"QY" = (
/obj/effect/turf_decal/weather/sand{
	dir = 8
	},
/obj/structure/flora/bush/fullgrass/style_random,
/obj/effect/light_emitter/interlink,
/turf/open/floor/grass,
/area/misc/condo)
"Rr" = (
/turf/closed/indestructible/hoteldoor{
	icon_state = "door_closed";
	icon = 'icons/obj/doors/puzzledoor/default.dmi'
	},
/area/misc/condo)
"RX" = (
/obj/structure/flora/bush/sparsegrass/style_random,
/turf/open/misc/beach/sand,
/area/misc/condo)
"SD" = (
/obj/effect/turf_decal/weather/sand{
	dir = 6
	},
/obj/structure/flora/bush/jungle/a/style_random,
/obj/effect/light_emitter/interlink,
/turf/open/floor/grass,
/area/misc/condo)
"SG" = (
/obj/machinery/room_controller/directional/west,
/turf/open/misc/beach/sand,
/area/misc/condo)
"Tk" = (
/obj/effect/turf_decal/weather/sand{
	dir = 5
	},
/obj/effect/light_emitter/interlink,
/turf/open/water{
	icon_state = "pool_1"
	},
/area/misc/condo)
"Wj" = (
/obj/effect/turf_decal/weather/sand{
	dir = 5
	},
/obj/structure/flora/bush/jungle/c/style_random,
/obj/effect/light_emitter/interlink,
/turf/open/floor/grass,
/area/misc/condo)
"Ys" = (
/obj/machinery/light/warm/directional/east,
/turf/open/floor/iron/terracotta,
/area/misc/condo)
"ZY" = (
/obj/structure/flora/tree/palm/style_2{
	density = 0
	},
/obj/effect/light_emitter/interlink,
/turf/open/floor/grass,
/area/misc/condo)

(1,1,1) = {"
xs
xs
xs
xs
xs
xs
xs
Ds
xs
xs
xs
xs
xs
xs
xs
"}
(2,1,1) = {"
xs
xs
QF
hX
QF
QF
SG
oK
QF
QF
QF
QF
jN
xs
xs
"}
(3,1,1) = {"
xs
RX
QF
dj
eo
dj
AM
dj
dj
PT
aY
eo
QF
bM
xs
"}
(4,1,1) = {"
xs
QF
EF
dj
Hx
nk
fL
rf
HP
yh
Wj
Nb
dj
QF
xs
"}
(5,1,1) = {"
xs
za
eo
ud
nU
fL
HP
HP
HP
HP
yh
DE
Bc
QF
xs
"}
(6,1,1) = {"
xs
QF
PT
pK
fL
HP
HP
HP
HP
HP
HP
LH
SD
QF
xs
"}
(7,1,1) = {"
xs
QF
ZY
zO
HP
HP
HP
HP
HP
HP
pt
SD
dj
QF
xs
"}
(8,1,1) = {"
xs
QF
kp
sU
Tk
HP
HP
HP
HP
pt
sB
dj
EF
QF
xs
"}
(9,1,1) = {"
xs
QF
eo
PJ
Pm
Tk
HP
HP
pt
eo
dj
dj
dj
RX
xs
"}
(10,1,1) = {"
xs
QF
dj
qq
dD
QY
Pw
dj
dj
if
QF
QF
QF
za
xs
"}
(11,1,1) = {"
xs
hX
dj
eo
Wj
En
oK
QF
QF
QF
rz
uY
iu
uY
uY
"}
(12,1,1) = {"
xs
QF
dj
CO
dj
EF
QF
uY
uY
aL
uY
uY
DT
AU
uY
"}
(13,1,1) = {"
xs
QF
dj
ap
sB
dj
QF
uY
pd
yt
iv
uY
cn
tQ
uY
"}
(14,1,1) = {"
xs
QF
AF
ap
dj
dj
QF
iu
FI
df
df
aL
df
Ys
uY
"}
(15,1,1) = {"
xs
xs
QF
QF
QF
za
RX
uY
qG
df
aT
uY
uY
uY
uY
"}
(16,1,1) = {"
xs
xs
xs
xs
xs
xs
xs
uY
uY
Rr
uY
uY
xs
xs
xs
"}
