//MAP CONVERTED BY dmm2tgm.py THIS HEADER COMMENT PREVENTS RECONVERSION, DO NOT REMOVE
"bN" = (
/turf/open/floor/iron/stairs{
	dir = 8;
	color = "AAAAAA"
	},
/area/misc/condo)
"ea" = (
/obj/effect/turf_decal/tile/dark_blue/half/contrasted{
	dir = 8
	},
/obj/machinery/shower/directional/east{
	refill_rate = 5
	},
/obj/structure/window/reinforced{
	dir = 8;
	pixel_x = -4
	},
/obj/structure/fluff/shower_drain{
	pixel_x = -8;
	pixel_y = -8
	},
/obj/machinery/light/directional/south,
/turf/open/floor/iron/white,
/area/misc/condo)
"fF" = (
/obj/effect/turf_decal/siding/dark{
	dir = 4
	},
/obj/effect/turf_decal/tile/dark_blue/anticorner{
	dir = 4
	},
/obj/machinery/light/directional/east,
/turf/open/floor/iron/white,
/area/misc/condo)
"fV" = (
/obj/effect/turf_decal/tile/dark_blue/half/contrasted{
	dir = 4
	},
/obj/machinery/shower/directional/west{
	refill_rate = 5
	},
/obj/structure/fluff/shower_drain{
	pixel_x = 8;
	pixel_y = -8
	},
/turf/open/floor/iron/white,
/area/misc/condo)
"gy" = (
/turf/open/floor/iron/stairs{
	dir = 4;
	color = "AAAAAA"
	},
/area/misc/condo)
"gH" = (
/obj/effect/turf_decal/siding/dark{
	dir = 4
	},
/obj/effect/turf_decal/tile/dark_blue/half/contrasted{
	dir = 4
	},
/obj/structure/table,
/obj/structure/towel_bin,
/obj/machinery/light/directional/east,
/turf/open/floor/iron/white,
/area/misc/condo)
"hJ" = (
/obj/structure/dresser{
	pixel_y = -7
	},
/turf/closed/indestructible/steel,
/area/misc/condo)
"ij" = (
/obj/effect/spawner/liquids_spawner/shoulders,
/turf/open/floor/iron/pool,
/area/misc/condo)
"ja" = (
/obj/effect/turf_decal/siding/dark{
	dir = 8
	},
/obj/effect/turf_decal/tile/dark_blue/half/contrasted{
	dir = 8
	},
/obj/structure/closet/secure_closet/personal/wall{
	pixel_x = -25
	},
/turf/open/floor/iron/white,
/area/misc/condo)
"jH" = (
/turf/closed/indestructible/steel,
/area/misc/condo)
"kx" = (
/obj/effect/turf_decal/siding/dark/corner,
/obj/effect/turf_decal/tile/dark_blue,
/turf/open/floor/iron/white,
/area/misc/condo)
"kX" = (
/obj/effect/turf_decal/siding/dark{
	dir = 8
	},
/obj/effect/turf_decal/tile/dark_blue/anticorner{
	dir = 8
	},
/turf/open/floor/iron/white,
/area/misc/condo)
"la" = (
/obj/effect/turf_decal/tile/dark_blue/half/contrasted{
	dir = 4
	},
/obj/machinery/shower/directional/west{
	refill_rate = 5
	},
/obj/structure/window/reinforced{
	dir = 4;
	pixel_x = 3
	},
/obj/structure/fluff/shower_drain{
	pixel_x = 8;
	pixel_y = -8
	},
/obj/machinery/light/directional/south,
/turf/open/floor/iron/white,
/area/misc/condo)
"mj" = (
/obj/effect/turf_decal/tile/dark_blue/half/contrasted{
	dir = 8
	},
/obj/structure/closet,
/obj/item/clothing/under/misc/skyrat/gear_harness,
/obj/machinery/room_controller/directional/west,
/turf/open/floor/iron,
/area/misc/condo)
"mD" = (
/turf/open/floor/iron/white,
/area/misc/condo)
"mF" = (
/obj/effect/turf_decal/siding/dark{
	dir = 4
	},
/obj/effect/turf_decal/tile/dark_blue/half/contrasted{
	dir = 4
	},
/obj/structure/chair{
	dir = 8
	},
/turf/open/floor/iron/white,
/area/misc/condo)
"nk" = (
/obj/effect/turf_decal/siding/dark{
	dir = 4
	},
/obj/effect/turf_decal/tile/dark_blue/half/contrasted{
	dir = 4
	},
/obj/structure/table,
/obj/machinery/light/directional/east,
/turf/open/floor/iron/white,
/area/misc/condo)
"pL" = (
/obj/effect/turf_decal/tile/dark_blue/half/contrasted{
	dir = 4
	},
/obj/structure/closet,
/obj/item/clothing/under/misc/skyrat/gear_harness,
/turf/open/floor/iron,
/area/misc/condo)
"qi" = (
/obj/effect/turf_decal/siding/dark/corner{
	dir = 4
	},
/obj/effect/turf_decal/tile/dark_blue{
	dir = 4
	},
/turf/open/floor/iron/white,
/area/misc/condo)
"qm" = (
/obj/effect/turf_decal/tile/dark_blue/half/contrasted{
	dir = 4
	},
/turf/open/floor/iron,
/area/misc/condo)
"rO" = (
/obj/structure/chair/sofa/bench/right{
	dir = 4;
	pixel_x = -8
	},
/obj/effect/turf_decal/tile/dark_blue/full,
/turf/open/floor/iron/large,
/area/misc/condo)
"tq" = (
/obj/effect/turf_decal/siding/dark{
	dir = 1
	},
/obj/effect/turf_decal/tile/dark_blue/half/contrasted{
	dir = 1
	},
/turf/open/floor/iron/white,
/area/misc/condo)
"tt" = (
/obj/structure/chair/sofa/bench/left{
	dir = 4;
	pixel_x = -8
	},
/obj/effect/turf_decal/tile/dark_blue/full,
/turf/open/floor/iron/large,
/area/misc/condo)
"tA" = (
/obj/structure/chair/sofa/bench/right{
	dir = 8;
	pixel_x = 8
	},
/obj/effect/turf_decal/tile/dark_blue/full,
/turf/open/floor/iron/large,
/area/misc/condo)
"tR" = (
/obj/effect/turf_decal/tile/dark_blue/half/contrasted{
	dir = 1
	},
/turf/open/floor/iron/white,
/area/misc/condo)
"uX" = (
/obj/effect/turf_decal/siding/dark/corner{
	dir = 1
	},
/obj/effect/turf_decal/tile/dark_blue{
	dir = 1
	},
/turf/open/floor/iron/white,
/area/misc/condo)
"vE" = (
/obj/effect/turf_decal/tile/dark_blue/half/contrasted{
	dir = 8
	},
/turf/open/floor/iron,
/area/misc/condo)
"vR" = (
/turf/closed/indestructible/hoteldoor/fakedoor,
/area/misc/condo)
"ym" = (
/obj/effect/turf_decal/siding/dark{
	dir = 4
	},
/obj/effect/turf_decal/tile/dark_blue/anticorner,
/turf/open/floor/iron/white,
/area/misc/condo)
"yN" = (
/obj/effect/turf_decal/siding/dark{
	dir = 8
	},
/obj/effect/turf_decal/tile/dark_blue/half/contrasted{
	dir = 8
	},
/obj/machinery/light/directional/west,
/turf/open/floor/iron/white,
/area/misc/condo)
"zC" = (
/obj/effect/turf_decal/siding/dark/corner{
	dir = 8
	},
/obj/effect/turf_decal/tile/dark_blue{
	dir = 8
	},
/turf/open/floor/iron/white,
/area/misc/condo)
"zV" = (
/obj/machinery/vending/vendcation{
	pixel_y = -6
	},
/turf/closed/indestructible/steel,
/area/misc/condo)
"BM" = (
/obj/effect/turf_decal/tile/dark_blue/half/contrasted{
	dir = 8
	},
/obj/machinery/shower/directional/east{
	refill_rate = 5
	},
/obj/structure/fluff/shower_drain{
	pixel_x = -8;
	pixel_y = -8
	},
/turf/open/floor/iron/white,
/area/misc/condo)
"BO" = (
/obj/effect/turf_decal/tile/dark_blue/half/contrasted{
	dir = 8
	},
/obj/structure/closet,
/obj/item/clothing/under/misc/skyrat/gear_harness,
/obj/machinery/light/directional/west,
/turf/open/floor/iron,
/area/misc/condo)
"BX" = (
/obj/machinery/door/airlock/bathroom,
/turf/open/floor/iron/white,
/area/misc/condo)
"CN" = (
/obj/effect/turf_decal/tile/dark_blue/half/contrasted{
	dir = 8
	},
/obj/machinery/shower/directional/east{
	refill_rate = 5
	},
/obj/structure/window/reinforced{
	dir = 8;
	pixel_x = -4
	},
/obj/structure/fluff/shower_drain{
	pixel_x = -8;
	pixel_y = -8
	},
/turf/open/floor/iron/white,
/area/misc/condo)
"Fy" = (
/obj/effect/turf_decal/siding/dark{
	dir = 8
	},
/obj/effect/turf_decal/tile/dark_blue/half/contrasted{
	dir = 8
	},
/obj/structure/chair{
	dir = 4
	},
/turf/open/floor/iron/white,
/area/misc/condo)
"Gd" = (
/obj/effect/turf_decal/tile/dark_blue/half/contrasted{
	dir = 4
	},
/obj/structure/closet,
/obj/item/clothing/under/misc/skyrat/gear_harness,
/obj/machinery/light/directional/east,
/turf/open/floor/iron,
/area/misc/condo)
"GH" = (
/obj/effect/turf_decal/siding/dark{
	dir = 8
	},
/obj/effect/turf_decal/tile/dark_blue/anticorner{
	dir = 1
	},
/obj/machinery/light/directional/west,
/turf/open/floor/iron/white,
/area/misc/condo)
"HM" = (
/obj/effect/turf_decal/tile/dark_blue/half/contrasted,
/turf/open/floor/iron/white,
/area/misc/condo)
"HX" = (
/obj/effect/turf_decal/siding/dark{
	dir = 8
	},
/obj/effect/turf_decal/tile/dark_blue/half/contrasted{
	dir = 8
	},
/obj/structure/table,
/obj/machinery/light/directional/west,
/obj/structure/towel_bin,
/turf/open/floor/iron/white,
/area/misc/condo)
"It" = (
/obj/effect/turf_decal/siding/dark{
	dir = 8
	},
/obj/effect/turf_decal/tile/dark_blue/half/contrasted{
	dir = 8
	},
/turf/open/floor/iron/white,
/area/misc/condo)
"MS" = (
/obj/effect/turf_decal/siding/dark{
	dir = 1
	},
/obj/effect/turf_decal/siding/dark,
/obj/effect/turf_decal/tile/dark_blue/half/contrasted,
/turf/open/floor/iron/white,
/area/misc/condo)
"NK" = (
/obj/effect/turf_decal/tile/dark_blue/half/contrasted{
	dir = 8
	},
/obj/structure/closet,
/obj/item/clothing/under/misc/skyrat/gear_harness,
/turf/open/floor/iron,
/area/misc/condo)
"Ot" = (
/obj/effect/turf_decal/siding/dark{
	dir = 8
	},
/obj/effect/turf_decal/tile/dark_blue/half/contrasted{
	dir = 8
	},
/obj/structure/fluff/shower_drain{
	pixel_x = -7;
	pixel_y = 0
	},
/turf/open/floor/iron/white,
/area/misc/condo)
"Ox" = (
/obj/effect/turf_decal/tile/dark_blue/half/contrasted{
	dir = 4
	},
/obj/machinery/shower/directional/west{
	refill_rate = 5
	},
/obj/structure/window/reinforced{
	dir = 4;
	pixel_x = 3
	},
/obj/structure/fluff/shower_drain{
	pixel_x = 8;
	pixel_y = -8
	},
/turf/open/floor/iron/white,
/area/misc/condo)
"ON" = (
/obj/effect/turf_decal/siding/dark{
	dir = 4
	},
/obj/effect/turf_decal/tile/dark_blue/half/contrasted{
	dir = 4
	},
/obj/structure/bed/pod{
	pixel_y = 1
	},
/turf/open/floor/iron/white,
/area/misc/condo)
"Qp" = (
/obj/effect/turf_decal/siding/dark{
	dir = 4
	},
/obj/effect/turf_decal/tile/dark_blue/half/contrasted{
	dir = 4
	},
/obj/machinery/light/directional/east,
/turf/open/floor/iron/white,
/area/misc/condo)
"Ru" = (
/obj/structure/chair/sofa/bench/left{
	dir = 8;
	pixel_x = 8
	},
/obj/effect/turf_decal/tile/dark_blue/full,
/turf/open/floor/iron/large,
/area/misc/condo)
"RJ" = (
/obj/effect/turf_decal/siding/dark{
	dir = 4
	},
/obj/effect/turf_decal/tile/dark_blue/half/contrasted{
	dir = 4
	},
/obj/item/clothing/under/suit/black,
/turf/open/floor/iron/white,
/area/misc/condo)
"TG" = (
/obj/effect/turf_decal/siding/dark{
	dir = 4
	},
/obj/effect/turf_decal/tile/dark_blue/half/contrasted{
	dir = 4
	},
/turf/open/floor/iron/white,
/area/misc/condo)
"Up" = (
/obj/structure/chair,
/obj/item/bikehorn/airhorn,
/turf/open/floor/iron/textured,
/area/misc/condo)
"YG" = (
/obj/effect/turf_decal/siding/dark,
/obj/effect/turf_decal/tile/dark_blue/half/contrasted,
/turf/open/floor/iron/white,
/area/misc/condo)
"YR" = (
/obj/effect/turf_decal/siding/dark{
	dir = 4
	},
/obj/effect/turf_decal/tile/dark_blue/half/contrasted{
	dir = 4
	},
/obj/structure/fluff/shower_drain{
	pixel_x = 7;
	pixel_y = 0
	},
/turf/open/floor/iron/white,
/area/misc/condo)

(1,1,1) = {"
jH
jH
jH
jH
jH
vR
vR
jH
jH
jH
jH
jH
jH
jH
jH
"}
(2,1,1) = {"
jH
jH
NK
BO
NK
vE
vE
mj
BO
NK
jH
BM
BM
BM
jH
"}
(3,1,1) = {"
jH
zV
qm
tA
Ru
qm
qm
tA
Ru
qm
BX
mD
Ox
la
jH
"}
(4,1,1) = {"
jH
hJ
vE
tt
rO
vE
vE
tt
rO
vE
BX
mD
CN
ea
jH
"}
(5,1,1) = {"
jH
jH
pL
Gd
pL
qm
qm
pL
Gd
pL
jH
fV
fV
fV
jH
"}
(6,1,1) = {"
jH
jH
jH
jH
jH
BX
BX
jH
jH
jH
jH
jH
jH
jH
jH
"}
(7,1,1) = {"
jH
GH
Fy
Fy
yN
It
It
HX
ja
ja
ja
ja
yN
kX
jH
"}
(8,1,1) = {"
jH
tR
kx
TG
YR
YR
RJ
TG
TG
YR
YR
TG
qi
HM
jH
"}
(9,1,1) = {"
jH
tR
YG
ij
ij
ij
ij
ij
ij
ij
ij
ij
tq
HM
jH
"}
(10,1,1) = {"
jH
bN
MS
ij
ij
ij
ij
ij
ij
ij
ij
ij
tq
HM
jH
"}
(11,1,1) = {"
jH
Up
MS
ij
ij
ij
ij
ij
ij
ij
ij
ij
tq
HM
jH
"}
(12,1,1) = {"
jH
gy
MS
ij
ij
ij
ij
ij
ij
ij
ij
ij
tq
HM
jH
"}
(13,1,1) = {"
jH
tR
YG
ij
ij
ij
ij
ij
ij
ij
ij
ij
tq
HM
jH
"}
(14,1,1) = {"
jH
tR
zC
It
Ot
Ot
It
It
It
Ot
Ot
It
uX
HM
jH
"}
(15,1,1) = {"
jH
fF
mF
mF
Qp
TG
ON
ON
gH
ON
ON
nk
TG
ym
jH
"}
(16,1,1) = {"
jH
jH
jH
jH
jH
jH
jH
jH
jH
jH
jH
jH
jH
jH
jH
"}
