//MAP CONVERTED BY dmm2tgm.py THIS HEADER COMMENT PREVENTS RECONVERSION, DO NOT REMOVE
"ab" = (
/obj/structure/chair/comfy/black,
/obj/item/clothing/glasses/hypno{
	pixel_y = 8;
	pixel_x = -3
	},
/obj/item/toy/figure/hos,
/turf/open/floor/iron,
/area/misc/condo)
"ag" = (
/obj/structure/hoop{
	dir = 4
	},
/obj/effect/turf_decal/trimline/white/filled/line{
	dir = 8
	},
/obj/machinery/light/directional/west,
/turf/open/floor/iron,
/area/misc/condo)
"bl" = (
/obj/structure/bed/double,
/obj/effect/spawner/random/bedsheet/double,
/turf/open/floor/iron/edge{
	dir = 1
	},
/area/misc/condo)
"cd" = (
/obj/machinery/room_controller/directional/south,
/turf/open/floor/iron/dark/side{
	dir = 10
	},
/area/misc/condo)
"cl" = (
/obj/machinery/oven/range,
/obj/structure/window/reinforced{
	dir = 1
	},
/turf/open/floor/iron/checker,
/area/misc/condo)
"cq" = (
/obj/machinery/light/directional/north,
/turf/open/floor/iron/dark/side{
	dir = 1
	},
/area/misc/condo)
"cz" = (
/obj/structure/table/reinforced,
/obj/machinery/reagentgrinder{
	pixel_y = 10;
	pixel_x = -5
	},
/turf/open/floor/iron/checker,
/area/misc/condo)
"dy" = (
/obj/structure/window/reinforced/spawner/directional/north{
	dir = 4
	},
/obj/item/shovel/spade{
	pixel_x = 4;
	pixel_y = 4
	},
/obj/item/hatchet{
	pixel_x = 10;
	pixel_y = 5
	},
/obj/item/secateurs{
	pixel_y = 5;
	pixel_x = -10
	},
/obj/item/plant_analyzer{
	pixel_y = -2
	},
/obj/structure/table/glass,
/turf/open/floor/grass,
/area/misc/condo)
"dR" = (
/obj/machinery/hydroponics/constructable/fullupgrade,
/turf/open/floor/grass,
/area/misc/condo)
"eD" = (
/obj/structure/table/reinforced,
/obj/item/kitchen/rollingpin{
	pixel_x = -10;
	pixel_y = 5
	},
/obj/item/knife/kitchen{
	pixel_y = 5;
	pixel_x = 10
	},
/turf/open/floor/iron/checker,
/area/misc/condo)
"fy" = (
/obj/item/toy/basketball,
/turf/open/floor/iron,
/area/misc/condo)
"gG" = (
/turf/closed/indestructible/hoteldoor/fakedoor{
	dir = 4
	},
/area/misc/condo)
"gN" = (
/turf/open/floor/iron/checker,
/area/misc/condo)
"iI" = (
/obj/effect/turf_decal/trimline/white/filled/line{
	dir = 6
	},
/turf/open/floor/iron,
/area/misc/condo)
"js" = (
/obj/machinery/door/airlock/hatch,
/turf/open/floor/iron,
/area/misc/condo)
"jw" = (
/obj/structure/sign/poster/contraband/got_wood,
/turf/closed/indestructible/reinforced,
/area/misc/condo)
"km" = (
/obj/machinery/light/directional/south,
/turf/open/floor/iron/checker,
/area/misc/condo)
"kK" = (
/obj/structure/window/reinforced{
	dir = 8
	},
/turf/open/floor/iron/checker,
/area/misc/condo)
"lc" = (
/obj/structure/table,
/obj/item/toy/figure/ian{
	pixel_x = 8
	},
/obj/item/toy/figure/hop{
	pixel_y = 2
	},
/obj/item/toy/figure/ian{
	pixel_x = -4;
	pixel_y = 2
	},
/obj/item/toy/figure/ian,
/obj/item/toy/figure/ian{
	pixel_x = 4;
	pixel_y = 2
	},
/obj/item/toy/figure/ian{
	pixel_x = -8
	},
/turf/open/floor/iron,
/area/misc/condo)
"mg" = (
/obj/item/clothing/mask/leatherwhip{
	pixel_x = -9;
	pixel_y = 4
	},
/turf/open/floor/iron,
/area/misc/condo)
"oj" = (
/obj/machinery/vending/dorms/prison,
/obj/item/toy/figure/assistant{
	pixel_y = 16
	},
/turf/open/floor/iron,
/area/misc/condo)
"ok" = (
/obj/effect/turf_decal/trimline/white/filled/line{
	dir = 1
	},
/turf/open/floor/iron,
/area/misc/condo)
"oq" = (
/obj/structure/chair/greyscale{
	dir = 1
	},
/turf/open/floor/iron,
/area/misc/condo)
"ov" = (
/turf/open/floor/iron,
/area/misc/condo)
"pd" = (
/obj/effect/turf_decal/trimline/white/filled/line{
	dir = 5
	},
/turf/open/floor/iron,
/area/misc/condo)
"pq" = (
/obj/effect/decal/cleanable/cum/femcum,
/turf/open/floor/iron,
/area/misc/condo)
"pP" = (
/obj/item/wallframe/status_display,
/turf/closed/indestructible/reinforced,
/area/misc/condo)
"rf" = (
/obj/structure/window/reinforced{
	dir = 1
	},
/obj/machinery/vending/dinnerware{
	default_price = 0;
	extra_price = 0;
	fair_market_price = 0
	},
/turf/open/floor/iron/checker,
/area/misc/condo)
"sb" = (
/obj/structure/window/reinforced{
	dir = 1
	},
/obj/structure/closet/secure_closet/freezer/kitchen/all_access,
/turf/open/floor/iron/checker,
/area/misc/condo)
"sl" = (
/obj/machinery/light/directional/north,
/turf/open/floor/iron,
/area/misc/condo)
"sr" = (
/obj/machinery/light/directional/south,
/turf/open/floor/iron,
/area/misc/condo)
"tv" = (
/obj/effect/turf_decal/trimline/white/filled/line,
/turf/open/floor/iron,
/area/misc/condo)
"ut" = (
/obj/machinery/light/warm/dim/directional/east,
/turf/open/floor/iron,
/area/misc/condo)
"uG" = (
/obj/structure/sign/poster/official/walk,
/turf/closed/indestructible/reinforced,
/area/misc/condo)
"vM" = (
/obj/structure/table/reinforced,
/turf/open/floor/iron/dark/side{
	dir = 1
	},
/area/misc/condo)
"wv" = (
/obj/structure/chair/greyscale,
/turf/open/floor/iron,
/area/misc/condo)
"wN" = (
/obj/effect/turf_decal/trimline/white/filled/line{
	dir = 10
	},
/turf/open/floor/iron,
/area/misc/condo)
"xN" = (
/obj/machinery/vending/hydroseeds{
	default_price = 0;
	extra_price = 0;
	fair_market_price = 0
	},
/obj/structure/window/reinforced/spawner/directional/east,
/obj/item/toy/figure/botanist{
	pixel_y = 16
	},
/turf/open/floor/grass,
/area/misc/condo)
"ze" = (
/turf/closed/indestructible/fakeglass,
/area/misc/condo)
"zl" = (
/obj/machinery/door/airlock,
/turf/open/floor/iron,
/area/misc/condo)
"zN" = (
/obj/machinery/door/airlock/security/old/glass,
/turf/open/floor/iron,
/area/misc/condo)
"BR" = (
/obj/structure/closet/crate/hydroponics,
/obj/item/reagent_containers/cup/beaker/large,
/obj/item/reagent_containers/cup/beaker/large,
/obj/item/reagent_containers/cup/beaker/large,
/obj/item/storage/bag/plants,
/turf/open/floor/grass,
/area/misc/condo)
"CW" = (
/obj/item/storage/box/nif_ghost_box/ghost_role,
/obj/structure/closet/crate/trashcart/laundry,
/turf/open/floor/iron,
/area/misc/condo)
"DF" = (
/obj/machinery/vending/sustenance,
/obj/structure/window/reinforced{
	dir = 8
	},
/obj/structure/window/reinforced{
	dir = 1;
	pixel_y = 1
	},
/obj/item/toy/figure/chef{
	pixel_y = 15
	},
/turf/open/floor/iron/checker,
/area/misc/condo)
"DK" = (
/obj/machinery/grill,
/obj/machinery/griddle,
/obj/structure/window/reinforced{
	dir = 1
	},
/turf/open/floor/iron/checker,
/area/misc/condo)
"DU" = (
/obj/machinery/washing_machine,
/turf/open/floor/iron,
/area/misc/condo)
"Ej" = (
/obj/structure/sink/kitchen/directional/east,
/turf/open/floor/grass,
/area/misc/condo)
"Gh" = (
/turf/closed/indestructible/reinforced,
/area/misc/condo)
"GD" = (
/obj/machinery/door/window/brigdoor/left/directional/east,
/turf/open/floor/grass,
/area/misc/condo)
"GQ" = (
/turf/open/floor/grass,
/area/misc/condo)
"HG" = (
/obj/effect/turf_decal/trimline/white/filled/line{
	dir = 9
	},
/turf/open/floor/iron,
/area/misc/condo)
"HM" = (
/turf/open/floor/iron/dark/side{
	dir = 1
	},
/area/misc/condo)
"Ip" = (
/obj/structure/table/reinforced,
/obj/item/clothing/suit/jacket/straight_jacket{
	pixel_y = -5
	},
/obj/item/clothing/mask/muzzle{
	pixel_y = 5
	},
/obj/item/clothing/glasses/blindfold{
	pixel_y = 7
	},
/turf/open/floor/iron/dark/side,
/area/misc/condo)
"IO" = (
/turf/open/floor/iron/dark/side,
/area/misc/condo)
"IW" = (
/obj/structure/falsewall/reinforced,
/turf/open/floor/iron,
/area/misc/condo)
"JN" = (
/obj/machinery/door/window{
	dir = 8
	},
/turf/open/floor/iron/checker,
/area/misc/condo)
"Ln" = (
/obj/item/toy/figure/secofficer{
	pixel_y = 16
	},
/obj/structure/showcase/fakesec,
/turf/open/floor/iron/dark/side{
	dir = 1
	},
/area/misc/condo)
"Mi" = (
/obj/machinery/smartfridge,
/turf/open/floor/iron/checker,
/area/misc/condo)
"ME" = (
/obj/structure/table/reinforced,
/obj/structure/table/reinforced,
/obj/machinery/processor,
/turf/open/floor/iron/checker,
/area/misc/condo)
"Nj" = (
/obj/item/stack/license_plates/empty/fifty,
/obj/item/stack/license_plates/empty/fifty,
/obj/item/stack/license_plates/empty/fifty,
/obj/structure/closet/crate/preopen,
/turf/open/floor/iron,
/area/misc/condo)
"Nz" = (
/obj/machinery/plate_press,
/turf/open/floor/iron,
/area/misc/condo)
"NG" = (
/obj/machinery/washing_machine,
/obj/item/toy/figure/prisoner{
	pixel_y = 10
	},
/turf/open/floor/iron,
/area/misc/condo)
"Os" = (
/turf/open/floor/iron/edge{
	dir = 1
	},
/area/misc/condo)
"OI" = (
/obj/machinery/deepfryer,
/obj/structure/window/reinforced{
	dir = 1
	},
/turf/open/floor/iron/checker,
/area/misc/condo)
"PW" = (
/obj/item/reagent_containers/cup/bottle/hexacrocin{
	pixel_x = -9
	},
/obj/machinery/light/very_dim/directional/north,
/turf/open/floor/iron,
/area/misc/condo)
"QH" = (
/obj/structure/sign/poster/official/boombox,
/turf/closed/indestructible/reinforced,
/area/misc/condo)
"QM" = (
/obj/machinery/prisongate,
/turf/open/floor/iron,
/area/misc/condo)
"Rb" = (
/obj/structure/chair/stool/directional/south,
/turf/open/floor/iron,
/area/misc/condo)
"Sn" = (
/obj/machinery/room_controller/directional/north,
/turf/open/floor/iron/dark/side{
	dir = 1
	},
/area/misc/condo)
"Sx" = (
/obj/machinery/vending/hydronutrients{
	default_price = 0;
	extra_price = 0;
	fair_market_price = 0
	},
/turf/open/floor/grass,
/area/misc/condo)
"SQ" = (
/obj/structure/table/reinforced,
/obj/item/storage/box/handcuffs{
	pixel_y = 2;
	pixel_x = 5
	},
/turf/open/floor/iron/dark/side{
	dir = 1
	},
/area/misc/condo)
"Tf" = (
/obj/structure/table,
/obj/machinery/light/floor,
/turf/open/floor/iron,
/area/misc/condo)
"To" = (
/obj/structure/window/reinforced/spawner/directional/east,
/turf/open/floor/grass,
/area/misc/condo)
"TH" = (
/obj/structure/hoop{
	dir = 8
	},
/obj/effect/turf_decal/trimline/white/filled/line{
	dir = 4
	},
/obj/machinery/light/directional/east,
/turf/open/floor/iron,
/area/misc/condo)
"Ut" = (
/obj/structure/table,
/turf/open/floor/iron,
/area/misc/condo)
"Uw" = (
/obj/structure/closet,
/obj/effect/spawner/random/entertainment/coin,
/obj/effect/spawner/random/entertainment/coin,
/obj/effect/spawner/random/entertainment/toy_figure,
/turf/open/floor/iron/dark/side,
/area/misc/condo)
"Va" = (
/obj/structure/bed,
/turf/open/floor/iron,
/area/misc/condo)
"Vy" = (
/obj/structure/closet/generic,
/turf/open/floor/iron/dark/side{
	dir = 9
	},
/area/misc/condo)
"Wn" = (
/obj/machinery/hydroponics/constructable/fullupgrade,
/obj/machinery/hydroponics/constructable/fullupgrade,
/obj/machinery/light/directional/west,
/turf/open/floor/grass,
/area/misc/condo)
"WY" = (
/obj/machinery/biogenerator,
/obj/structure/window/reinforced/spawner/directional/north,
/turf/open/floor/grass,
/area/misc/condo)
"Xp" = (
/obj/structure/window/reinforced/spawner/directional/north,
/turf/open/floor/grass,
/area/misc/condo)
"Xv" = (
/obj/structure/table,
/obj/item/toy/cards/deck/cas{
	pixel_y = 10;
	pixel_x = 8
	},
/obj/item/toy/cards/deck/cas/black,
/turf/open/floor/iron,
/area/misc/condo)
"Zt" = (
/obj/structure/window/reinforced/spawner/directional/east,
/obj/structure/window/reinforced/spawner/directional/north,
/obj/machinery/seed_extractor,
/turf/open/floor/grass,
/area/misc/condo)

(1,1,1) = {"
Gh
Gh
Gh
Gh
Gh
Gh
Gh
Gh
Gh
Gh
Gh
Gh
Gh
gG
Gh
"}
(2,1,1) = {"
Gh
Os
ov
zl
ov
ov
WY
dR
Wn
Ej
BR
Gh
Vy
cd
Gh
"}
(3,1,1) = {"
Gh
sl
ov
pP
oj
ov
Xp
GQ
GQ
GQ
Sx
uG
SQ
IO
Gh
"}
(4,1,1) = {"
Gh
bl
ov
jw
sl
ov
Zt
dy
GD
To
xN
ze
vM
IO
Gh
"}
(5,1,1) = {"
Gh
Gh
Gh
jw
ov
ov
ov
ov
ov
ov
ov
ze
Ln
IO
Gh
"}
(6,1,1) = {"
ze
HG
ag
wN
ov
ov
wv
Xv
Ut
oq
sr
QH
cq
IO
Gh
"}
(7,1,1) = {"
ze
ok
ov
tv
ov
ov
wv
lc
Ut
oq
ov
zN
ov
IO
Gh
"}
(8,1,1) = {"
ze
ok
fy
tv
ov
ov
ov
ov
ov
ov
ov
QM
ov
IO
Gh
"}
(9,1,1) = {"
ze
ok
ov
tv
ov
ov
Tf
DF
kK
JN
Mi
Gh
HM
IO
Gh
"}
(10,1,1) = {"
ze
ok
ov
tv
ov
Rb
Nz
rf
gN
gN
gN
Gh
Sn
Uw
Gh
"}
(11,1,1) = {"
ze
pd
TH
iI
ov
ov
Nj
DK
gN
cz
gN
Gh
cq
Ip
Gh
"}
(12,1,1) = {"
Gh
Gh
Gh
Gh
sl
Rb
Nz
cl
gN
ME
km
Gh
js
Gh
Gh
"}
(13,1,1) = {"
Gh
ab
pq
IW
CW
ov
Tf
OI
gN
eD
gN
Gh
ov
ov
Gh
"}
(14,1,1) = {"
Gh
PW
mg
Gh
NG
DU
ov
sb
gN
gN
gN
Gh
ut
Va
Gh
"}
(15,1,1) = {"
Gh
Gh
Gh
Gh
Gh
Gh
Gh
Gh
Gh
Gh
Gh
Gh
Gh
Gh
Gh
"}
