//MAP CONVERTED BY dmm2tgm.py THIS HEADER COMMENT PREVENTS RECONVERSION, DO NOT REMOVE
"bc" = (
/obj/structure/bed/pod{
	dir = 4
	},
/obj/item/bedsheet/medical{
	dir = 4
	},
/obj/effect/turf_decal/tile/blue/opposingcorners,
/turf/open/indestructible/white,
/area/misc/condo)
"bf" = (
/obj/effect/turf_decal/siding/thinplating_new/light{
	dir = 4
	},
/obj/item/banner/medical/mundane,
/obj/structure/window/spawner/directional/east,
/obj/structure/sign/poster/official/random/directional/north,
/turf/open/indestructible/hotelwood,
/area/misc/condo)
"bO" = (
/obj/structure/flora/bush/flowers_br/style_random,
/obj/structure/flora/bush/flowers_yw/style_random,
/obj/structure/flora/bush/flowers_pp/style_random,
/obj/structure/window/reinforced/fulltile{
	icon_state = "reinforced_window-12"
	},
/turf/open/floor/grass,
/area/misc/condo)
"dr" = (
/obj/effect/turf_decal/trimline/blue/filled/line{
	dir = 6
	},
/obj/item/kirbyplants/random/fullysynthetic,
/turf/open/indestructible/white,
/area/misc/condo)
"eh" = (
/turf/closed/indestructible/steel,
/area/misc/condo)
"eH" = (
/obj/effect/turf_decal/trimline/blue/filled/warning{
	dir = 1
	},
/obj/item/kirbyplants/random/fullysynthetic,
/turf/open/indestructible/white,
/area/misc/condo)
"eZ" = (
/obj/effect/turf_decal/trimline/blue/filled/corner{
	dir = 8
	},
/turf/open/indestructible/white,
/area/misc/condo)
"gu" = (
/obj/machinery/door/airlock/medical{
	name = "Nurse Room"
	},
/obj/effect/turf_decal/tile/blue/opposingcorners,
/turf/open/indestructible/white/textured,
/area/misc/condo)
"hV" = (
/obj/machinery/light/cold/directional/west,
/obj/machinery/vending/coffee,
/obj/structure/sign/poster/official/random/directional/west,
/turf/open/indestructible/hotelwood,
/area/misc/condo)
"ib" = (
/obj/effect/turf_decal/trimline/blue/filled/line{
	dir = 8
	},
/turf/open/indestructible/white,
/area/misc/condo)
"kc" = (
/obj/structure/chair/office/light{
	dir = 1
	},
/obj/effect/turf_decal/tile/blue/opposingcorners,
/turf/open/indestructible/white/textured,
/area/misc/condo)
"kq" = (
/obj/effect/turf_decal/siding/thinplating_new/light{
	dir = 4
	},
/obj/structure/chair,
/obj/structure/window/spawner/directional/east,
/turf/open/indestructible/hotelwood,
/area/misc/condo)
"lr" = (
/obj/effect/turf_decal/trimline/blue/filled/line{
	dir = 10
	},
/obj/item/banner/medical/mundane,
/turf/open/indestructible/white,
/area/misc/condo)
"lL" = (
/obj/effect/turf_decal/siding/thinplating_new/light,
/obj/structure/chair{
	dir = 4
	},
/obj/structure/window/spawner/directional/south,
/turf/open/indestructible/hotelwood,
/area/misc/condo)
"mB" = (
/obj/item/clothing/suit/toggle/labcoat/hospitalgown,
/obj/structure/closet,
/obj/item/clothing/glasses/regular/hipster,
/obj/item/clothing/shoes/sneakers/white,
/obj/effect/turf_decal/tile/blue/opposingcorners,
/turf/open/indestructible/white,
/area/misc/condo)
"nv" = (
/obj/effect/turf_decal/trimline/blue/filled/line{
	dir = 5
	},
/obj/item/kirbyplants/random/fullysynthetic,
/turf/open/indestructible/white,
/area/misc/condo)
"pu" = (
/obj/effect/turf_decal/trimline/blue/filled/warning{
	dir = 1
	},
/turf/open/indestructible/white/smooth_large,
/area/misc/condo)
"pA" = (
/obj/effect/turf_decal/tile/blue/opposingcorners,
/obj/machinery/light/cold/directional/north,
/turf/open/indestructible/white,
/area/misc/condo)
"pB" = (
/obj/item/kirbyplants/random/fullysynthetic,
/obj/effect/turf_decal/tile/blue/opposingcorners,
/obj/machinery/light/cold/directional/north,
/turf/open/indestructible/white/textured,
/area/misc/condo)
"pW" = (
/obj/structure/table,
/obj/item/book/manual/random{
	pixel_x = -5;
	pixel_y = 3
	},
/obj/effect/turf_decal/tile/blue/opposingcorners,
/obj/item/reagent_containers/cup/glass/mug/coco{
	pixel_x = 8
	},
/obj/machinery/computer/security/telescreen/entertainment/directional/north,
/turf/open/indestructible/white,
/area/misc/condo)
"qf" = (
/obj/structure/chair{
	dir = 1
	},
/turf/open/indestructible/carpet,
/area/misc/condo)
"rH" = (
/obj/effect/turf_decal/tile/blue/opposingcorners,
/obj/structure/sign/poster/official/random/directional/south,
/obj/item/kirbyplants/random/fullysynthetic,
/turf/open/indestructible/white/textured,
/area/misc/condo)
"te" = (
/obj/item/kirbyplants/random/fullysynthetic,
/obj/effect/turf_decal/trimline/blue/filled/line{
	dir = 10
	},
/turf/open/indestructible/white,
/area/misc/condo)
"uf" = (
/obj/effect/turf_decal/siding/thinplating_new/light{
	dir = 6
	},
/obj/structure/window/spawner/directional/south,
/obj/structure/window/spawner/directional/east,
/obj/structure/table,
/obj/item/reagent_containers/cup/glass/coffee{
	pixel_x = 5;
	pixel_y = 14
	},
/obj/item/reagent_containers/cup/glass/coffee{
	pixel_x = -7;
	pixel_y = 2
	},
/turf/open/indestructible/hotelwood,
/area/misc/condo)
"uD" = (
/obj/effect/turf_decal/tile/blue/opposingcorners,
/obj/machinery/door/airlock/medical{
	name = "Recovery Room"
	},
/turf/open/indestructible/white,
/area/misc/condo)
"vl" = (
/obj/effect/turf_decal/tile/blue/opposingcorners,
/turf/open/indestructible/white/textured,
/area/misc/condo)
"vP" = (
/obj/structure/sign/departments/medbay/alt,
/turf/closed/indestructible/steel,
/area/misc/condo)
"vW" = (
/obj/structure/table,
/obj/effect/turf_decal/tile/blue/opposingcorners,
/obj/item/reagent_containers/spray/cleaner{
	pixel_x = 9;
	pixel_y = 4
	},
/obj/item/folder/white{
	pixel_x = -4;
	pixel_y = 2
	},
/obj/item/clothing/gloves/latex/nitrile{
	pixel_x = -13
	},
/obj/machinery/digital_clock/directional/south,
/turf/open/indestructible/white/textured,
/area/misc/condo)
"wy" = (
/turf/closed/indestructible/hoteldoor/fakedoor{
	dir = 4
	},
/area/misc/condo)
"wO" = (
/obj/structure/table,
/obj/effect/turf_decal/tile/blue/opposingcorners,
/obj/item/reagent_containers/cup/glass/waterbottle/large{
	pixel_x = -7;
	pixel_y = 7
	},
/obj/machinery/computer/security/telescreen/entertainment/directional/south,
/turf/open/indestructible/white,
/area/misc/condo)
"xt" = (
/obj/item/kirbyplants/random/fullysynthetic,
/obj/effect/turf_decal/tile/blue/opposingcorners,
/turf/open/indestructible/white/textured,
/area/misc/condo)
"yi" = (
/obj/effect/turf_decal/trimline/blue/filled/line,
/obj/machinery/light/cold/directional/south,
/obj/structure/chair{
	dir = 1
	},
/turf/open/indestructible/white,
/area/misc/condo)
"yy" = (
/obj/structure/chair{
	dir = 4
	},
/turf/open/indestructible/hotelwood,
/area/misc/condo)
"yB" = (
/obj/effect/turf_decal/trimline/blue/filled/warning{
	dir = 8
	},
/obj/machinery/light/cold/directional/west,
/turf/open/indestructible/white,
/area/misc/condo)
"yF" = (
/obj/effect/turf_decal/trimline/blue/filled/line{
	dir = 1
	},
/obj/structure/chair,
/turf/open/indestructible/white,
/area/misc/condo)
"yM" = (
/obj/structure/table,
/obj/structure/showcase/machinery/microwave{
	pixel_y = 2
	},
/turf/open/indestructible/hotelwood,
/area/misc/condo)
"yO" = (
/obj/effect/turf_decal/trimline/blue/filled/line,
/obj/item/kirbyplants/random/fullysynthetic,
/obj/structure/sign/poster/official/random/directional/south,
/turf/open/indestructible/white,
/area/misc/condo)
"yT" = (
/obj/effect/turf_decal/trimline/blue/filled/line,
/obj/item/kirbyplants/random/fullysynthetic,
/turf/open/indestructible/white,
/area/misc/condo)
"zl" = (
/obj/effect/turf_decal/trimline/blue/filled/line{
	dir = 8
	},
/obj/machinery/light/cold/directional/west,
/turf/open/indestructible/white,
/area/misc/condo)
"zB" = (
/obj/machinery/computer{
	icon_screen = "medcomp"
	},
/obj/effect/turf_decal/tile/blue/opposingcorners,
/turf/open/indestructible/white/textured,
/area/misc/condo)
"Au" = (
/obj/effect/turf_decal/trimline/blue/filled/warning,
/turf/open/indestructible/white/smooth_large,
/area/misc/condo)
"BZ" = (
/obj/machinery/computer{
	icon_screen = "crew"
	},
/obj/effect/turf_decal/tile/blue/opposingcorners,
/turf/open/indestructible/white/textured,
/area/misc/condo)
"Cg" = (
/obj/effect/turf_decal/tile/blue/opposingcorners,
/obj/machinery/light/cold/directional/south,
/turf/open/indestructible/white,
/area/misc/condo)
"Cz" = (
/obj/effect/turf_decal/trimline/blue/filled/line{
	dir = 6
	},
/obj/item/banner/medical/mundane,
/turf/open/indestructible/white,
/area/misc/condo)
"CW" = (
/obj/effect/turf_decal/trimline/blue/filled/warning{
	dir = 9
	},
/obj/item/banner/medical/mundane,
/turf/open/indestructible/white,
/area/misc/condo)
"DQ" = (
/obj/effect/turf_decal/tile/blue/opposingcorners,
/obj/structure/chair{
	dir = 1
	},
/turf/open/indestructible/white,
/area/misc/condo)
"Eh" = (
/obj/effect/turf_decal/siding/thinplating_new/light{
	dir = 4
	},
/turf/open/indestructible/hotelwood,
/area/misc/condo)
"EH" = (
/obj/machinery/vending/dorms,
/turf/open/indestructible/hotelwood,
/area/misc/condo)
"ET" = (
/obj/effect/turf_decal/trimline/blue/filled/corner{
	dir = 1
	},
/turf/open/indestructible/white,
/area/misc/condo)
"Gr" = (
/obj/effect/turf_decal/trimline/blue/filled/line{
	dir = 4
	},
/obj/machinery/iv_drip,
/turf/open/indestructible/white,
/area/misc/condo)
"GC" = (
/obj/effect/turf_decal/trimline/blue/filled/line{
	dir = 4
	},
/obj/vehicle/ridden/wheelchair{
	dir = 8
	},
/turf/open/indestructible/white,
/area/misc/condo)
"GD" = (
/turf/open/indestructible/white/smooth_large,
/area/misc/condo)
"GH" = (
/obj/structure/closet,
/obj/item/clothing/suit/toggle/labcoat/hospitalgown,
/obj/item/clothing/glasses/regular/hipster,
/obj/item/clothing/shoes/sneakers/white,
/obj/effect/turf_decal/tile/blue/opposingcorners,
/turf/open/indestructible/white,
/area/misc/condo)
"Hv" = (
/turf/open/indestructible/carpet,
/area/misc/condo)
"HX" = (
/obj/effect/turf_decal/tile/blue/opposingcorners,
/turf/open/indestructible/white,
/area/misc/condo)
"Ic" = (
/obj/effect/turf_decal/trimline/blue/filled/line,
/obj/structure/chair{
	dir = 1
	},
/turf/open/indestructible/white,
/area/misc/condo)
"Is" = (
/obj/machinery/door/window/left/directional/west{
	name = "Nurse Control Windoor"
	},
/obj/effect/turf_decal/tile/blue/opposingcorners,
/obj/structure/table/reinforced,
/turf/open/indestructible/white/textured,
/area/misc/condo)
"Iv" = (
/obj/effect/turf_decal/tile/blue/opposingcorners,
/obj/machinery/iv_drip,
/obj/machinery/digital_clock/directional/south,
/turf/open/indestructible/white,
/area/misc/condo)
"JF" = (
/obj/effect/turf_decal/trimline/blue/filled/line,
/obj/structure/table,
/obj/effect/spawner/random/entertainment/plushie,
/turf/open/indestructible/white,
/area/misc/condo)
"JK" = (
/obj/effect/turf_decal/trimline/blue/filled/corner,
/turf/open/indestructible/white,
/area/misc/condo)
"JT" = (
/obj/structure/table,
/obj/machinery/computer/security/telescreen/entertainment/directional/north,
/obj/item/toy/cards/deck{
	pixel_x = -7;
	pixel_y = 11
	},
/obj/machinery/light/cold/directional/north,
/turf/open/indestructible/hotelwood,
/area/misc/condo)
"KA" = (
/obj/structure/table,
/obj/item/storage/box/cups{
	pixel_x = 5;
	pixel_y = 15
	},
/obj/item/reagent_containers/cup/glass/waterbottle/large{
	pixel_x = -8;
	pixel_y = 20
	},
/obj/item/reagent_containers/cup/glass/waterbottle/large{
	pixel_x = -8;
	pixel_y = 11
	},
/obj/item/reagent_containers/cup/glass/mug/nanotrasen{
	pixel_x = 4;
	pixel_y = 2
	},
/obj/effect/turf_decal/siding/thinplating_new/light,
/obj/structure/window/spawner/directional/south,
/obj/structure/sign/calendar/directional/west,
/turf/open/indestructible/hotelwood,
/area/misc/condo)
"KB" = (
/obj/effect/turf_decal/trimline/blue/filled/warning{
	dir = 8
	},
/turf/open/indestructible/white/smooth_large,
/area/misc/condo)
"KM" = (
/obj/machinery/vending/wardrobe/medi_wardrobe/ghost_cafe,
/obj/effect/turf_decal/tile/blue/opposingcorners,
/obj/item/paper{
	icon_state = "alienpaper_words";
	base_icon_state = "alienpaper_words";
	default_raw_text = "Don't abuse this and our trust.";
	name = "fair warning";
	pixel_x = -2;
	pixel_y = -2
	},
/turf/open/indestructible/white/textured,
/area/misc/condo)
"Ly" = (
/obj/effect/turf_decal/trimline/blue/filled/warning{
	dir = 8
	},
/turf/open/indestructible/white,
/area/misc/condo)
"Lz" = (
/obj/effect/turf_decal/trimline/blue/filled/line,
/obj/machinery/light/cold/directional/south,
/obj/structure/reagent_dispensers/water_cooler,
/turf/open/indestructible/white,
/area/misc/condo)
"LC" = (
/turf/closed/indestructible/fakeglass,
/area/misc/condo)
"Oj" = (
/obj/effect/turf_decal/tile/blue/opposingcorners,
/obj/structure/chair{
	dir = 4
	},
/turf/open/indestructible/white,
/area/misc/condo)
"Ou" = (
/obj/effect/turf_decal/trimline/blue/filled/line{
	dir = 4
	},
/obj/item/banner/medical/mundane,
/obj/machinery/light/cold/directional/east,
/turf/open/indestructible/white,
/area/misc/condo)
"Ox" = (
/obj/structure/chair{
	dir = 8
	},
/turf/open/indestructible/hotelwood,
/area/misc/condo)
"OB" = (
/obj/item/kirbyplants/random/fullysynthetic,
/obj/effect/turf_decal/tile/blue/opposingcorners,
/turf/open/indestructible/white,
/area/misc/condo)
"Pw" = (
/obj/effect/spawner/structure/window/reinforced,
/turf/open/floor/plating,
/area/misc/condo)
"QL" = (
/obj/machinery/door/airlock/medical{
	name = "Recovery Room"
	},
/obj/effect/turf_decal/tile/blue/opposingcorners,
/turf/open/indestructible/white,
/area/misc/condo)
"RW" = (
/obj/effect/turf_decal/trimline/blue/filled/warning{
	dir = 9
	},
/obj/item/kirbyplants/random/fullysynthetic,
/turf/open/indestructible/white,
/area/misc/condo)
"Sc" = (
/turf/open/space/basic,
/area/misc/condo)
"Sg" = (
/obj/structure/noticeboard/directional/north,
/turf/open/indestructible/hotelwood,
/area/misc/condo)
"Sm" = (
/obj/effect/turf_decal/tile/blue/opposingcorners,
/obj/vehicle/ridden/wheelchair{
	dir = 8
	},
/obj/machinery/digital_clock/directional/north,
/turf/open/indestructible/white,
/area/misc/condo)
"SB" = (
/obj/effect/turf_decal/siding/thinplating_new/light,
/turf/open/indestructible/hotelwood,
/area/misc/condo)
"TF" = (
/obj/structure/bookcase/random,
/obj/structure/sign/clock/directional/west,
/turf/open/indestructible/hotelwood,
/area/misc/condo)
"Uo" = (
/obj/effect/turf_decal/trimline/blue/filled/corner{
	dir = 4
	},
/turf/open/indestructible/white,
/area/misc/condo)
"UX" = (
/obj/effect/turf_decal/trimline/blue/filled/warning{
	dir = 1
	},
/turf/open/indestructible/white,
/area/misc/condo)
"VG" = (
/obj/structure/flora/bush/flowers_br/style_random,
/obj/structure/flora/bush/flowers_yw/style_random,
/obj/structure/flora/bush/flowers_pp/style_random,
/obj/structure/window/reinforced/fulltile{
	icon_state = "reinforced_window-3"
	},
/turf/open/floor/grass,
/area/misc/condo)
"VN" = (
/obj/structure/table,
/obj/effect/turf_decal/tile/blue/opposingcorners,
/obj/item/clipboard{
	pixel_y = 4;
	pixel_x = -5
	},
/obj/item/paper{
	pixel_x = -5;
	pixel_y = 3
	},
/obj/item/pen/blue{
	pixel_x = -5;
	pixel_y = 3
	},
/obj/item/clothing/glasses/hud/health{
	pixel_x = 10;
	pixel_y = 10
	},
/turf/open/indestructible/white/textured,
/area/misc/condo)
"YD" = (
/obj/effect/spawner/structure/window/reinforced,
/obj/structure/curtain/bounty,
/turf/open/floor/plating,
/area/misc/condo)
"Zm" = (
/obj/effect/turf_decal/trimline/blue/filled/line{
	dir = 1
	},
/obj/item/kirbyplants/random/fullysynthetic,
/obj/machinery/room_controller/directional/north,
/turf/open/indestructible/white,
/area/misc/condo)
"ZH" = (
/obj/effect/turf_decal/trimline/blue/filled/line{
	dir = 4
	},
/turf/open/indestructible/white,
/area/misc/condo)

(1,1,1) = {"
eh
eh
eh
eh
eh
eh
LC
wy
LC
eh
LC
wy
LC
eh
eh
"}
(2,1,1) = {"
eh
TF
EH
hV
yM
KA
CW
KB
lr
Pw
KM
vl
rH
eh
Sc
"}
(3,1,1) = {"
eh
Sg
Hv
Hv
Hv
SB
UX
GD
Au
gu
vl
vl
vl
bO
Sc
"}
(4,1,1) = {"
eh
yy
Hv
Hv
Hv
SB
UX
GD
yi
Pw
pB
vl
xt
bO
Sc
"}
(5,1,1) = {"
eh
JT
qf
Hv
Hv
SB
UX
GD
JF
Pw
zB
vl
VN
bO
Sc
"}
(6,1,1) = {"
eh
Ox
Hv
Hv
Hv
lL
UX
GD
Ic
Pw
BZ
kc
vW
eh
Sc
"}
(7,1,1) = {"
eh
bf
Eh
Eh
kq
uf
eH
GD
yT
vP
Pw
Is
Pw
eh
Sc
"}
(8,1,1) = {"
LC
RW
Ly
Ly
Ly
yB
ET
GD
eZ
zl
ib
KB
te
bO
Sc
"}
(9,1,1) = {"
wy
pu
GD
GD
GD
GD
GD
GD
GD
GD
GD
GD
Lz
bO
Sc
"}
(10,1,1) = {"
LC
nv
GC
Gr
GC
ZH
Uo
GD
JK
ZH
ZH
ZH
Cz
bO
Sc
"}
(11,1,1) = {"
eh
YD
YD
YD
YD
eh
Zm
GD
yO
eh
YD
YD
YD
eh
eh
"}
(12,1,1) = {"
eh
pW
bc
DQ
OB
YD
yF
GD
Ic
YD
OB
Oj
bc
wO
eh
"}
(13,1,1) = {"
eh
pA
HX
HX
HX
uD
pu
GD
Au
QL
HX
HX
HX
Cg
eh
"}
(14,1,1) = {"
eh
Sm
HX
HX
mB
YD
nv
Ou
dr
YD
GH
HX
HX
Iv
eh
"}
(15,1,1) = {"
eh
VG
VG
VG
VG
eh
VG
VG
VG
eh
VG
VG
VG
VG
eh
"}
(16,1,1) = {"
Sc
Sc
Sc
Sc
Sc
Sc
Sc
Sc
Sc
Sc
Sc
Sc
Sc
Sc
Sc
"}
