//MAP CONVERTED BY dmm2tgm.py THIS HEADER COMMENT PREVENTS RECONVERSION, DO NOT REMOVE
"bL" = (
/obj/structure/table/wood/poker,
/obj/effect/spawner/random/trash/soap,
/turf/open/floor/wood,
/area/misc/condo)
"bS" = (
/obj/machinery/portable_atmospherics/canister/air,
/turf/open/floor/plating,
/area/misc/condo)
"bY" = (
/obj/effect/decal/cleanable/dirt/dust,
/turf/open/floor/wood/parquet,
/area/misc/condo)
"cx" = (
/obj/structure/reagent_dispensers/watertank,
/obj/effect/decal/cleanable/dirt,
/turf/open/floor/iron,
/area/misc/condo)
"dZ" = (
/obj/effect/decal/cleanable/dirt,
/obj/machinery/vending/boozeomat,
/turf/open/floor/wood/parquet,
/area/misc/condo)
"ea" = (
/obj/structure/table,
/obj/item/stack/spacecash/c10,
/turf/open/floor/plating,
/area/misc/condo)
"fQ" = (
/obj/structure/chair/wood{
	dir = 4
	},
/obj/effect/mapping_helpers/broken_floor,
/obj/effect/decal/cleanable/dirt,
/turf/open/floor/wood/parquet,
/area/misc/condo)
"fW" = (
/obj/effect/mapping_helpers/broken_floor,
/obj/effect/decal/cleanable/dirt,
/turf/open/floor/wood/parquet,
/area/misc/condo)
"gd" = (
/obj/structure/chair/wood{
	dir = 8
	},
/obj/effect/decal/cleanable/dirt,
/turf/open/floor/wood/parquet,
/area/misc/condo)
"gf" = (
/obj/effect/decal/cleanable/dirt,
/obj/effect/decal/cleanable/dirt/dust,
/turf/open/floor/wood,
/area/misc/condo)
"gp" = (
/obj/machinery/barsign/all_access{
	dir = 1
	},
/turf/closed/indestructible/steel,
/area/misc/condo)
"gB" = (
/obj/machinery/vending/cigarette/beach,
/obj/effect/turf_decal/tile/dark/full,
/obj/machinery/light/warm/directional/east,
/turf/open/floor/iron/large,
/area/misc/condo)
"gG" = (
/obj/machinery/door/firedoor,
/obj/effect/turf_decal/stripes/line,
/obj/effect/turf_decal/stripes/line{
	dir = 1
	},
/turf/open/floor/iron,
/area/misc/condo)
"gT" = (
/obj/structure/cable,
/obj/machinery/atmospherics/pipe/smart/manifold4w/supply/hidden/layer4,
/obj/machinery/atmospherics/pipe/smart/manifold4w/scrubbers/hidden/layer2,
/turf/closed/indestructible/steel,
/area/misc/condo)
"hu" = (
/obj/structure/disposalpipe/segment{
	dir = 9
	},
/obj/effect/turf_decal/tile/neutral,
/turf/open/floor/iron,
/area/misc/condo)
"ig" = (
/obj/structure/table/wood/poker,
/turf/open/floor/wood/parquet,
/area/misc/condo)
"iQ" = (
/turf/open/floor/plating,
/area/misc/condo)
"iS" = (
/obj/effect/spawner/structure/window/reinforced,
/turf/open/floor/plating,
/area/misc/condo)
"jv" = (
/obj/machinery/chem_dispenser/drinks/beer/fullupgrade,
/obj/structure/table/wood/poker,
/obj/effect/mapping_helpers/broken_floor,
/obj/machinery/light/small/directional/north,
/turf/open/floor/wood/parquet,
/area/misc/condo)
"jH" = (
/obj/structure/chair/wood{
	dir = 8
	},
/turf/open/floor/wood/parquet,
/area/misc/condo)
"jW" = (
/obj/structure/chair/sofa/right/brown,
/turf/open/floor/wood,
/area/misc/condo)
"kt" = (
/obj/structure/table/wood/poker,
/obj/item/stack/spacecash/c10,
/obj/effect/decal/cleanable/dirt,
/turf/open/floor/wood/parquet,
/area/misc/condo)
"lu" = (
/obj/structure/disposalpipe/segment{
	dir = 5
	},
/obj/effect/turf_decal/tile/neutral/fourcorners,
/turf/open/floor/iron,
/area/misc/condo)
"lA" = (
/obj/machinery/light/small/dim/directional/east,
/turf/open/floor/plating,
/area/misc/condo)
"lH" = (
/obj/structure/chair/stool/bar/directional/north,
/obj/effect/turf_decal/siding/wood{
	dir = 1
	},
/obj/effect/decal/cleanable/dirt,
/turf/open/floor/wood,
/area/misc/condo)
"lJ" = (
/obj/structure/disposalpipe/trunk,
/obj/effect/turf_decal/tile/neutral/fourcorners,
/turf/open/floor/iron,
/area/misc/condo)
"mz" = (
/obj/structure/disposalpipe/segment,
/obj/effect/turf_decal/tile/neutral,
/turf/open/floor/iron,
/area/misc/condo)
"mE" = (
/obj/effect/turf_decal/tile/neutral/fourcorners,
/turf/open/floor/iron,
/area/misc/condo)
"nM" = (
/obj/structure/disposalpipe/segment{
	dir = 6
	},
/obj/effect/turf_decal/tile/neutral,
/turf/open/floor/iron,
/area/misc/condo)
"oh" = (
/obj/structure/table/wood,
/turf/open/floor/wood/parquet,
/area/misc/condo)
"pg" = (
/obj/structure/table,
/obj/item/mop/advanced,
/obj/effect/decal/cleanable/dirt,
/turf/open/floor/iron,
/area/misc/condo)
"ps" = (
/obj/machinery/disposal/bin,
/obj/structure/disposalpipe/trunk{
	dir = 8
	},
/obj/effect/turf_decal/tile/dark/full,
/turf/open/floor/iron/large,
/area/misc/condo)
"qA" = (
/obj/structure/chair/sofa/middle/brown,
/obj/effect/decal/cleanable/dirt,
/turf/open/floor/wood,
/area/misc/condo)
"qS" = (
/obj/machinery/door/firedoor,
/obj/effect/turf_decal/stripes/line,
/obj/effect/turf_decal/stripes/line{
	dir = 1
	},
/obj/effect/turf_decal/caution/stand_clear,
/turf/open/floor/iron,
/area/misc/condo)
"ry" = (
/obj/effect/mapping_helpers/broken_floor,
/obj/effect/turf_decal/siding/wood{
	dir = 8
	},
/obj/machinery/light/small/directional/south,
/turf/open/floor/wood,
/area/misc/condo)
"rW" = (
/obj/machinery/door/firedoor,
/obj/effect/turf_decal/stripes/line,
/obj/effect/turf_decal/stripes/line{
	dir = 1
	},
/obj/effect/turf_decal/caution/stand_clear{
	dir = 1
	},
/turf/open/floor/iron,
/area/misc/condo)
"rZ" = (
/obj/structure/closet/wardrobe/botanist,
/obj/item/wrench,
/obj/item/screwdriver,
/turf/open/floor/plating,
/area/misc/condo)
"si" = (
/obj/structure/closet/crate,
/obj/effect/decal/cleanable/dirt,
/obj/machinery/light/small/directional/west,
/turf/open/floor/plating,
/area/misc/condo)
"to" = (
/obj/structure/closet/crate,
/obj/item/stack/sheet/iron/fifty,
/obj/item/stack/sheet/mineral/wood/fifty,
/obj/effect/decal/cleanable/dirt,
/turf/open/floor/plating,
/area/misc/condo)
"tw" = (
/obj/effect/decal/cleanable/dirt/dust,
/turf/open/floor/wood,
/area/misc/condo)
"tN" = (
/obj/machinery/door/airlock/maintenance_hatch{
	name = "Maintenance Hatch"
	},
/turf/open/floor/plating,
/area/misc/condo)
"tX" = (
/obj/structure/rack,
/obj/item/storage/pill_bottle/maintenance_pill/full,
/turf/open/floor/plating,
/area/misc/condo)
"uI" = (
/obj/effect/decal/cleanable/dirt,
/turf/open/floor/iron,
/area/misc/condo)
"vo" = (
/turf/closed/indestructible/steel,
/area/misc/condo)
"vs" = (
/obj/effect/mapping_helpers/broken_floor,
/obj/effect/decal/cleanable/dirt,
/obj/machinery/light/small/broken/directional/east,
/turf/open/floor/wood,
/area/misc/condo)
"vS" = (
/obj/effect/turf_decal/tile/neutral,
/obj/machinery/light/warm/directional/east,
/turf/open/floor/iron,
/area/misc/condo)
"xK" = (
/obj/structure/closet/wardrobe/botanist,
/obj/effect/decal/cleanable/dirt,
/turf/open/floor/plating,
/area/misc/condo)
"ym" = (
/obj/structure/table/wood/poker,
/obj/item/reagent_containers/cup/glass/shaker,
/turf/open/floor/wood/parquet,
/area/misc/condo)
"yI" = (
/obj/effect/turf_decal/siding/wood,
/obj/effect/decal/cleanable/dirt,
/turf/open/floor/wood,
/area/misc/condo)
"zq" = (
/obj/structure/chair/stool/bar/directional/west,
/obj/effect/decal/cleanable/dirt,
/turf/open/floor/plating,
/area/misc/condo)
"zH" = (
/obj/structure/cable,
/obj/machinery/atmospherics/pipe/smart/manifold4w/supply/hidden/layer4,
/obj/machinery/atmospherics/pipe/smart/manifold4w/scrubbers/hidden/layer2,
/obj/effect/decal/cleanable/dirt,
/turf/open/floor/plating,
/area/misc/condo)
"Ab" = (
/turf/open/floor/wood,
/area/misc/condo)
"AJ" = (
/obj/item/stack/cable_coil/cut,
/mob/living/basic/mouse,
/obj/machinery/atmospherics/pipe/smart/manifold4w/supply/hidden/layer4,
/obj/machinery/atmospherics/pipe/smart/manifold4w/scrubbers/hidden/layer2,
/obj/effect/decal/cleanable/dirt,
/turf/open/floor/plating,
/area/misc/condo)
"Bj" = (
/obj/structure/table/wood/poker,
/obj/item/storage/box/drinkingglasses,
/obj/effect/decal/cleanable/dirt,
/turf/open/floor/wood/parquet,
/area/misc/condo)
"Cj" = (
/obj/effect/decal/cleanable/dirt,
/obj/effect/decal/cleanable/blood/old,
/turf/open/floor/wood/parquet,
/area/misc/condo)
"Ds" = (
/obj/structure/rack,
/obj/item/crowbar,
/obj/effect/decal/cleanable/dirt,
/turf/open/floor/plating,
/area/misc/condo)
"DA" = (
/obj/machinery/vending/coffee,
/obj/effect/turf_decal/tile/dark/full,
/turf/open/floor/iron/large,
/area/misc/condo)
"DU" = (
/obj/effect/turf_decal/tile/neutral,
/turf/open/floor/iron,
/area/misc/condo)
"Eg" = (
/turf/closed/wall/space{
	space_lit = 1
	},
/area/misc/condo)
"FS" = (
/obj/structure/table/wood/poker,
/obj/effect/decal/cleanable/dirt/dust,
/turf/open/floor/wood/parquet,
/area/misc/condo)
"Il" = (
/obj/effect/turf_decal/siding/wood,
/obj/effect/decal/cleanable/dirt,
/obj/machinery/light/small/broken/directional/west,
/turf/open/floor/wood,
/area/misc/condo)
"Jd" = (
/obj/structure/closet/firecloset,
/turf/open/floor/plating,
/area/misc/condo)
"Ka" = (
/obj/structure/cable,
/obj/machinery/atmospherics/pipe/smart/manifold4w/supply/hidden/layer4,
/obj/machinery/atmospherics/pipe/smart/manifold4w/scrubbers/hidden/layer2,
/turf/open/floor/plating,
/area/misc/condo)
"Kn" = (
/obj/effect/decal/cleanable/dirt,
/turf/open/floor/plating,
/area/misc/condo)
"KT" = (
/obj/effect/turf_decal/tile/neutral{
	dir = 8
	},
/turf/open/floor/iron,
/area/misc/condo)
"Lb" = (
/obj/structure/table,
/obj/item/soap/deluxe,
/obj/effect/decal/cleanable/dirt,
/obj/item/storage/box/lights/mixed,
/turf/open/floor/iron,
/area/misc/condo)
"Lh" = (
/turf/closed/indestructible/hoteldoor{
	icon_state = "closed";
	icon = 'modular_skyrat/modules/aesthetics/airlock/icons/airlocks/station2/glass.dmi'
	},
/area/misc/condo)
"LF" = (
/obj/structure/steam_vent,
/obj/structure/cable,
/obj/machinery/atmospherics/pipe/smart/manifold4w/supply/hidden/layer4,
/obj/machinery/atmospherics/pipe/smart/manifold4w/scrubbers/hidden/layer2,
/obj/effect/decal/cleanable/dirt,
/turf/open/floor/plating,
/area/misc/condo)
"Mz" = (
/obj/machinery/chem_dispenser/drinks/fullupgrade,
/obj/structure/table/wood/poker,
/turf/open/floor/wood/parquet,
/area/misc/condo)
"MS" = (
/obj/structure/chair/wood{
	dir = 4
	},
/turf/open/floor/wood/parquet,
/area/misc/condo)
"Of" = (
/turf/open/floor/wood/parquet,
/area/misc/condo)
"Oz" = (
/obj/effect/decal/cleanable/dirt,
/obj/machinery/light/small/directional/north,
/turf/open/floor/plating,
/area/misc/condo)
"Pk" = (
/obj/effect/mapping_helpers/broken_floor,
/obj/effect/decal/cleanable/dirt,
/turf/open/floor/plating,
/area/misc/condo)
"PQ" = (
/obj/effect/turf_decal/tile/neutral{
	dir = 8
	},
/obj/machinery/light/warm/directional/west,
/turf/open/floor/iron,
/area/misc/condo)
"Qu" = (
/obj/structure/closet/emcloset,
/turf/open/floor/plating,
/area/misc/condo)
"QL" = (
/obj/structure/chair/wood{
	dir = 8
	},
/turf/open/floor/wood,
/area/misc/condo)
"QR" = (
/obj/structure/table/wood,
/obj/effect/decal/cleanable/dirt,
/turf/open/floor/wood,
/area/misc/condo)
"QZ" = (
/obj/structure/grille/broken,
/obj/structure/cable,
/obj/machinery/atmospherics/pipe/smart/manifold4w/supply/hidden/layer4,
/obj/machinery/atmospherics/pipe/smart/manifold4w/scrubbers/hidden/layer2,
/obj/effect/decal/cleanable/dirt,
/turf/open/floor/plating,
/area/misc/condo)
"Rd" = (
/obj/effect/turf_decal/tile/neutral,
/obj/machinery/room_controller/directional/east,
/turf/open/floor/iron,
/area/misc/condo)
"SA" = (
/obj/structure/table/wood/fancy,
/obj/item/pizzabox/pineapple,
/turf/open/floor/wood,
/area/misc/condo)
"SF" = (
/obj/effect/decal/cleanable/dirt,
/obj/structure/sink/directional/south,
/obj/structure/mirror/broken/directional/north,
/obj/machinery/light/small/dim/directional/west,
/turf/open/floor/iron,
/area/misc/condo)
"Tf" = (
/obj/structure/cable,
/obj/machinery/atmospherics/pipe/smart/manifold4w/supply/hidden/layer4,
/obj/machinery/atmospherics/pipe/smart/manifold4w/scrubbers/hidden/layer2,
/obj/machinery/light/small/broken/directional/north,
/turf/open/floor/plating,
/area/misc/condo)
"Th" = (
/obj/structure/chair/stool/bar/directional/north,
/obj/effect/turf_decal/siding/wood{
	dir = 1
	},
/turf/open/floor/wood,
/area/misc/condo)
"TO" = (
/obj/structure/table/wood,
/turf/open/floor/wood,
/area/misc/condo)
"TX" = (
/obj/effect/decal/cleanable/dirt,
/obj/effect/decal/cleanable/blood/old,
/obj/effect/decal/cleanable/vomit/old,
/obj/structure/toilet{
	dir = 8
	},
/turf/open/floor/iron,
/area/misc/condo)
"Wk" = (
/obj/structure/cable,
/obj/machinery/atmospherics/pipe/smart/manifold4w/supply/hidden/layer4,
/obj/machinery/atmospherics/pipe/smart/manifold4w/scrubbers/hidden/layer2,
/obj/effect/turf_decal/tile/neutral,
/turf/open/floor/iron,
/area/misc/condo)
"Xh" = (
/obj/machinery/door/airlock/maintenance_hatch{
	name = "Maintenance Hatch"
	},
/obj/structure/cable,
/obj/machinery/atmospherics/pipe/smart/manifold4w/supply/hidden/layer4,
/obj/machinery/atmospherics/pipe/smart/manifold4w/scrubbers/hidden/layer2,
/turf/open/floor/plating,
/area/misc/condo)
"XK" = (
/obj/structure/chair/wood{
	dir = 4
	},
/obj/effect/decal/cleanable/dirt,
/turf/open/floor/wood,
/area/misc/condo)
"Yp" = (
/obj/machinery/atmospherics/pipe/smart/manifold4w/scrubbers/hidden/layer2,
/obj/machinery/atmospherics/pipe/smart/manifold4w/supply/hidden/layer4,
/turf/closed/indestructible/steel,
/area/misc/condo)
"Yu" = (
/obj/structure/table/wood/poker,
/turf/open/floor/wood,
/area/misc/condo)
"YG" = (
/obj/effect/mapping_helpers/broken_floor,
/turf/open/floor/wood,
/area/misc/condo)
"Za" = (
/obj/structure/sink/kitchen{
	desc = "A sink used for washing one's hands and face. It looks rusty and home-made";
	name = "old sink";
	pixel_y = 23
	},
/obj/structure/mop_bucket,
/obj/effect/decal/cleanable/dirt,
/turf/open/floor/iron,
/area/misc/condo)
"Zp" = (
/obj/effect/turf_decal/siding/wood,
/obj/effect/decal/cleanable/dirt/dust,
/turf/open/floor/wood,
/area/misc/condo)
"ZL" = (
/obj/structure/chair/sofa/left/brown,
/obj/effect/decal/cleanable/dirt,
/turf/open/floor/wood,
/area/misc/condo)
"ZZ" = (
/obj/effect/decal/cleanable/dirt,
/turf/open/floor/wood,
/area/misc/condo)

(1,1,1) = {"
vo
vo
vo
vo
vo
vo
vo
vo
vo
vo
vo
vo
vo
vo
vo
"}
(2,1,1) = {"
vo
Lh
KT
KT
KT
PQ
KT
qS
KT
KT
KT
PQ
KT
Lh
vo
"}
(3,1,1) = {"
vo
Lh
mE
mE
mE
mE
mE
gG
mE
mE
mE
lJ
lu
Lh
vo
"}
(4,1,1) = {"
vo
Lh
vS
DU
Rd
DU
Wk
rW
DU
DU
nM
mz
hu
Lh
vo
"}
(5,1,1) = {"
vo
vo
vo
vo
vo
vo
Xh
vo
gB
DA
ps
vo
vo
vo
vo
"}
(6,1,1) = {"
vo
ea
to
Ds
vo
si
LF
vo
vo
vo
vo
vo
Ab
kt
vo
"}
(7,1,1) = {"
vo
zq
Kn
iQ
tN
Kn
Ka
bS
vo
Yu
bL
Il
MS
fQ
gp
"}
(8,1,1) = {"
vo
Oz
Kn
Kn
vo
Kn
Ka
iQ
tN
ZZ
YG
Zp
oh
oh
vo
"}
(9,1,1) = {"
vo
xK
rZ
vo
vo
Kn
zH
Jd
vo
YG
XK
yI
gd
jH
vo
"}
(10,1,1) = {"
vo
vo
vo
vo
QZ
AJ
Ka
Qu
vo
Pk
TO
Ab
ry
vo
vo
"}
(11,1,1) = {"
vo
SF
tN
zH
zH
vo
vo
vo
vo
gf
QL
jW
tw
iS
Eg
"}
(12,1,1) = {"
vo
TX
gT
Tf
tX
vo
ym
Of
Bj
lH
YG
qA
ZZ
iS
Eg
"}
(13,1,1) = {"
Yp
Yp
Yp
tN
vo
vo
Mz
fW
FS
lH
XK
ZL
YG
iS
Eg
"}
(14,1,1) = {"
vo
Za
uI
Kn
Lb
vo
jv
Cj
ig
Th
QR
tw
SA
iS
Eg
"}
(15,1,1) = {"
vo
cx
lA
uI
pg
vo
dZ
bY
Kn
vs
QL
vo
iS
iS
Eg
"}
(16,1,1) = {"
vo
vo
vo
vo
vo
vo
vo
vo
vo
vo
vo
vo
Eg
Eg
Eg
"}
