//MAP CONVERTED BY dmm2tgm.py THIS HEADER COMMENT PREVENTS RECONVERSION, DO NOT REMOVE
"ax" = (
/obj/effect/turf_decal/trimline/dark_red/filled/corner{
	dir = 4
	},
/turf/open/indestructible/dark/textured,
/area/misc/condo)
"aK" = (
/obj/effect/turf_decal/trimline/dark_red/filled/line{
	dir = 10
	},
/obj/machinery/light/directional/south,
/obj/item/kirbyplants/organic/plant24,
/turf/open/indestructible/dark/textured,
/area/misc/condo)
"aU" = (
/obj/structure/railing/corner/end/unbreakable{
	dir = 4
	},
/turf/open/floor/carpet/black,
/area/misc/condo)
"bp" = (
/obj/effect/turf_decal/siding/thinplating_new/dark/corner{
	dir = 1
	},
/obj/effect/turf_decal/trimline/dark_red/filled/warning{
	dir = 4
	},
/obj/effect/turf_decal/trimline/neutral/filled/line{
	dir = 4
	},
/turf/open/indestructible/dark/textured,
/area/misc/condo)
"bJ" = (
/obj/effect/turf_decal/siding/thinplating_new/dark{
	dir = 8
	},
/obj/effect/turf_decal/trimline/dark_red/filled/corner,
/obj/machinery/light/floor,
/turf/open/indestructible/dark/textured,
/area/misc/condo)
"ce" = (
/obj/effect/turf_decal/trimline/dark_red/filled/line{
	dir = 5
	},
/turf/open/indestructible/dark/textured,
/area/misc/condo)
"cj" = (
/obj/effect/turf_decal/trimline/dark_red/filled/warning{
	dir = 6
	},
/obj/effect/turf_decal/trimline/neutral/filled/line{
	dir = 4
	},
/turf/open/indestructible/dark/textured,
/area/misc/condo)
"dt" = (
/obj/effect/turf_decal/siding/thinplating_new/dark{
	dir = 8
	},
/obj/structure/railing/unbreakable{
	dir = 8
	},
/obj/structure/showcase/mecha/ripley{
	icon_state = "mauler"
	},
/turf/open/floor/mineral/plastitanium/red,
/area/misc/condo)
"dX" = (
/obj/item/kirbyplants/organic/plant21,
/obj/effect/turf_decal/trimline/dark_red/filled/line{
	dir = 8
	},
/turf/open/indestructible/dark/textured,
/area/misc/condo)
"ep" = (
/obj/effect/turf_decal/trimline/dark_red/filled/corner{
	dir = 1
	},
/turf/open/indestructible/dark/textured,
/area/misc/condo)
"ff" = (
/obj/effect/turf_decal/skyrat_decals/syndicate/middle/left,
/turf/open/floor/mineral/plastitanium/red,
/area/misc/condo)
"fh" = (
/turf/closed/wall/space{
	space_lit = 1
	},
/area/misc/condo)
"fi" = (
/obj/effect/turf_decal/siding/thinplating_new/dark{
	dir = 9
	},
/obj/structure/railing/unbreakable{
	dir = 9
	},
/obj/structure/showcase/cyborg{
	desc = "A stand with the empty body of a Cybersun cyborg bolted to it.";
	dir = 8;
	icon = 'icons/mob/silicon/robots.dmi';
	icon_state = "synd_sec";
	name = "syndicate cyborg showcase";
	pixel_x = 6
	},
/turf/open/floor/mineral/plastitanium/red,
/area/misc/condo)
"gs" = (
/obj/structure/table/reinforced/plastitaniumglass,
/obj/item/folder/white,
/obj/item/toy/gun,
/turf/open/floor/carpet/royalblack,
/area/misc/condo)
"gL" = (
/obj/effect/turf_decal/trimline/dark_red/filled/line{
	dir = 9
	},
/turf/open/indestructible/dark/textured,
/area/misc/condo)
"gN" = (
/turf/open/floor/iron/stairs/medium{
	dir = 8
	},
/area/misc/condo)
"gP" = (
/obj/item/kirbyplants/organic/plant24,
/obj/effect/turf_decal/trimline/dark_red/filled/line{
	dir = 8
	},
/turf/open/indestructible/dark/textured,
/area/misc/condo)
"he" = (
/obj/effect/turf_decal/trimline/dark_red/filled/corner{
	dir = 8
	},
/turf/open/indestructible/dark/textured,
/area/misc/condo)
"hn" = (
/obj/effect/turf_decal/skyrat_decals/syndicate/middle/middle,
/turf/open/floor/mineral/plastitanium/red,
/area/misc/condo)
"hQ" = (
/turf/open/floor/fakespace,
/area/misc/condo)
"iw" = (
/obj/effect/turf_decal/siding/thinplating_new/dark{
	dir = 8
	},
/obj/structure/railing/unbreakable{
	dir = 8
	},
/obj/structure/showcase/mecha/marauder{
	icon_state = "darkgygax"
	},
/turf/open/floor/mineral/plastitanium/red,
/area/misc/condo)
"iL" = (
/obj/effect/turf_decal/siding/thinplating_new/dark/corner{
	dir = 4
	},
/turf/open/floor/wood/large,
/area/misc/condo)
"jQ" = (
/obj/effect/turf_decal/trimline/dark_red/filled/line{
	dir = 6
	},
/turf/open/indestructible/dark/textured,
/area/misc/condo)
"kz" = (
/obj/structure/railing/corner/end/flip{
	dir = 8
	},
/obj/effect/turf_decal/trimline/dark_red/filled/line{
	dir = 8
	},
/turf/open/indestructible/dark/textured,
/area/misc/condo)
"mB" = (
/obj/machinery/light/directional/north,
/turf/open/floor/iron/stairs/left{
	dir = 8
	},
/area/misc/condo)
"mQ" = (
/obj/effect/turf_decal/siding/thinplating_new/dark{
	dir = 4
	},
/obj/structure/railing/unbreakable{
	dir = 4
	},
/obj/structure/showcase/mecha/ripley{
	icon_state = "mauler"
	},
/turf/open/floor/mineral/plastitanium/red,
/area/misc/condo)
"mV" = (
/obj/machinery/light/directional/south,
/turf/open/floor/iron/stairs/right{
	dir = 8
	},
/area/misc/condo)
"nt" = (
/obj/effect/turf_decal/siding/thinplating_new/dark/corner,
/turf/open/indestructible/dark/textured,
/area/misc/condo)
"qf" = (
/obj/structure/table/reinforced/plastitaniumglass,
/obj/item/phone{
	pixel_x = 7;
	pixel_y = -2;
	desc = "Standard red phone, but somehow evil-er";
	name = "BLOOD-red phone"
	},
/obj/item/flashlight/lamp{
	pixel_x = -5;
	pixel_y = 10
	},
/turf/open/floor/carpet/royalblack,
/area/misc/condo)
"qR" = (
/obj/structure/table/reinforced/plastitaniumglass,
/obj/item/storage/fancy/cigarettes/cigars/havana{
	pixel_y = 5;
	pixel_x = 4
	},
/obj/item/lighter{
	pixel_y = -2;
	pixel_x = -8
	},
/turf/open/indestructible/dark/textured,
/area/misc/condo)
"qV" = (
/obj/effect/turf_decal/siding/thinplating_new/dark,
/turf/open/floor/wood/large,
/area/misc/condo)
"rS" = (
/obj/effect/turf_decal/siding/thinplating_new/dark{
	dir = 10
	},
/obj/structure/railing/unbreakable{
	dir = 10
	},
/obj/structure/showcase/cyborg{
	desc = "A stand with the empty body of a Cybersun cyborg bolted to it.";
	dir = 8;
	icon = 'icons/mob/silicon/robots.dmi';
	icon_state = "synd_sec";
	name = "syndicate cyborg showcase";
	pixel_x = 6
	},
/turf/open/floor/mineral/plastitanium/red,
/area/misc/condo)
"sc" = (
/obj/effect/turf_decal/siding/thinplating_new/dark{
	dir = 5
	},
/obj/structure/railing/unbreakable{
	dir = 5
	},
/obj/structure/showcase/cyborg{
	desc = "A stand with the empty body of a Cybersun cyborg bolted to it.";
	dir = 4;
	icon = 'icons/mob/silicon/robots.dmi';
	icon_state = "synd_sec";
	name = "syndicate cyborg showcase";
	pixel_x = -6
	},
/turf/open/floor/mineral/plastitanium/red,
/area/misc/condo)
"tb" = (
/obj/effect/turf_decal/siding/thinplating_new/dark{
	dir = 1
	},
/obj/structure/chair/comfy/shuttle{
	color = "#474747";
	dir = 1
	},
/turf/open/indestructible/dark/textured,
/area/misc/condo)
"tq" = (
/obj/effect/turf_decal/siding/thinplating_new/dark/corner{
	dir = 8
	},
/obj/effect/turf_decal/trimline/dark_red/filled/warning{
	dir = 4
	},
/obj/effect/turf_decal/trimline/neutral/filled/line{
	dir = 4
	},
/turf/open/indestructible/dark/textured,
/area/misc/condo)
"tv" = (
/obj/effect/turf_decal/delivery,
/obj/machinery/vending/cigarette,
/turf/open/indestructible/dark/textured{
	icon_state = "engine"
	},
/area/misc/condo)
"tD" = (
/obj/effect/turf_decal/trimline/dark_red/filled/line{
	dir = 1
	},
/turf/open/indestructible/dark/textured,
/area/misc/condo)
"tH" = (
/obj/effect/turf_decal/skyrat_decals/syndicate/middle/right,
/obj/structure/table/reinforced/plastitaniumglass,
/obj/machinery{
	icon = 'modular_skyrat/modules/aesthetics/intercom/icons/intercom.dmi';
	icon_state = "intercom";
	name = "Intercom"
	},
/turf/open/floor/mineral/plastitanium/red,
/area/misc/condo)
"ua" = (
/obj/effect/turf_decal/trimline/dark_red/filled/line{
	dir = 4
	},
/turf/open/indestructible/dark/textured,
/area/misc/condo)
"uK" = (
/obj/effect/turf_decal/trimline/dark_red/filled/line{
	dir = 9
	},
/obj/machinery/light/directional/north,
/obj/machinery/recharge_station,
/turf/open/indestructible/dark/textured,
/area/misc/condo)
"vy" = (
/obj/effect/turf_decal/siding/thinplating_new/dark,
/obj/structure/chair/comfy/shuttle{
	color = "#474747"
	},
/turf/open/indestructible/dark/textured,
/area/misc/condo)
"wz" = (
/obj/effect/turf_decal/siding/thinplating_new/dark{
	dir = 4
	},
/obj/structure/railing/unbreakable{
	dir = 4
	},
/obj/structure/showcase/mecha/marauder{
	icon_state = "darkgygax"
	},
/turf/open/floor/mineral/plastitanium/red,
/area/misc/condo)
"wX" = (
/obj/effect/turf_decal/skyrat_decals/syndicate/top/right,
/obj/structure/table/reinforced/plastitaniumglass,
/obj/item/reagent_containers/cup/glass/coffee/colonial{
	pixel_x = -12;
	pixel_y = 1
	},
/obj/item/paper_bin{
	pixel_y = 4
	},
/obj/item/pen/fountain{
	pixel_y = 5
	},
/turf/open/floor/mineral/plastitanium/red,
/area/misc/condo)
"ye" = (
/obj/effect/turf_decal/skyrat_decals/syndicate/top/left,
/obj/structure/table/reinforced/plastitaniumglass,
/obj/item/storage/fancy/cigarettes/cigpack_robust{
	pixel_x = -6;
	pixel_y = 2
	},
/obj/item/lighter{
	pixel_y = -2;
	pixel_x = 5
	},
/turf/open/floor/mineral/plastitanium/red,
/area/misc/condo)
"yf" = (
/obj/effect/turf_decal/siding/thinplating_new/dark{
	dir = 4
	},
/turf/open/indestructible/dark/textured,
/area/misc/condo)
"yS" = (
/obj/structure/railing/corner/end/flip{
	dir = 4
	},
/turf/open/floor/carpet/black,
/area/misc/condo)
"yX" = (
/obj/effect/turf_decal/trimline/dark_red/filled/warning{
	dir = 5
	},
/obj/effect/turf_decal/trimline/neutral/filled/line{
	dir = 4
	},
/turf/open/indestructible/dark/textured,
/area/misc/condo)
"zb" = (
/obj/effect/turf_decal/skyrat_decals/syndicate/top/middle,
/obj/structure/table/reinforced/plastitaniumglass,
/obj/item/storage/fancy/cigarettes/cigars/havana{
	pixel_y = 5;
	pixel_x = 4
	},
/turf/open/floor/mineral/plastitanium/red,
/area/misc/condo)
"zp" = (
/obj/effect/turf_decal/trimline/dark_red/filled/line{
	dir = 10
	},
/turf/open/indestructible/dark/textured,
/area/misc/condo)
"Aa" = (
/obj/effect/turf_decal/siding/thinplating_new/dark{
	dir = 5
	},
/turf/open/floor/wood/large,
/area/misc/condo)
"Av" = (
/obj/effect/turf_decal/siding/thinplating_new/dark/corner{
	dir = 4
	},
/turf/open/indestructible/dark/textured,
/area/misc/condo)
"AJ" = (
/turf/closed/indestructible/hoteldoor/fakedoor,
/area/misc/condo)
"BQ" = (
/obj/effect/turf_decal/delivery,
/obj/machinery/vending/boozeomat,
/turf/open/indestructible/dark/textured{
	icon_state = "engine"
	},
/area/misc/condo)
"De" = (
/obj/effect/turf_decal/siding/thinplating_new/dark{
	dir = 8
	},
/obj/structure/chair/comfy/shuttle{
	color = "#DD2211";
	dir = 8
	},
/turf/open/indestructible/dark/textured,
/area/misc/condo)
"DL" = (
/obj/item/kirbyplants/organic/plant22,
/obj/structure/sign/warning/yes_smoking/circle/directional/north,
/obj/effect/turf_decal/trimline/dark_red/filled,
/obj/machinery/room_controller/directional/west,
/turf/open/indestructible/dark/textured,
/area/misc/condo)
"En" = (
/obj/structure/railing/unbreakable{
	dir = 1
	},
/turf/open/floor/iron/stairs/left{
	dir = 8
	},
/area/misc/condo)
"EH" = (
/obj/effect/turf_decal/trimline/dark_red/filled/line{
	dir = 8
	},
/turf/open/indestructible/dark/textured,
/area/misc/condo)
"FM" = (
/obj/effect/turf_decal/trimline/neutral/filled/line,
/obj/effect/turf_decal/trimline/dark_red/filled/warning,
/turf/open/indestructible/dark/textured,
/area/misc/condo)
"FQ" = (
/turf/open/indestructible/dark/textured,
/area/misc/condo)
"FS" = (
/obj/effect/turf_decal/siding/thinplating_new/dark{
	dir = 4
	},
/turf/open/floor/carpet/royalblack,
/area/misc/condo)
"Gp" = (
/obj/effect/turf_decal/trimline/dark_red/filled/corner,
/turf/open/indestructible/dark/textured,
/area/misc/condo)
"Gu" = (
/obj/effect/turf_decal/trimline/dark_red/filled/line{
	dir = 5
	},
/obj/item/kirbyplants/organic/plant22,
/turf/open/indestructible/dark/textured,
/area/misc/condo)
"HZ" = (
/obj/machinery/vending/wardrobe/syndie_wardrobe/ghost_cafe{
	contraband = list();
	premium = list();
	vend_reply = "Clown.";
	products = list(/obj/item/clothing/accessory/clown_enjoyer_pin = 1);
	zubbers_products = null
	},
/obj/effect/turf_decal/delivery,
/turf/open/indestructible/dark/textured{
	icon_state = "engine"
	},
/area/misc/condo)
"IT" = (
/obj/item/kirbyplants/organic/plant22,
/obj/effect/turf_decal/trimline/dark_red/filled,
/turf/open/indestructible/dark/textured,
/area/misc/condo)
"JB" = (
/obj/structure/railing/corner/end/unbreakable{
	dir = 8
	},
/obj/effect/turf_decal/trimline/dark_red/filled/line{
	dir = 8
	},
/turf/open/indestructible/dark/textured,
/area/misc/condo)
"JN" = (
/obj/structure/table/reinforced/plastitaniumglass,
/obj/item/paper_bin{
	pixel_y = 6;
	pixel_x = -4
	},
/obj/item/stamp/granted{
	pixel_x = 9;
	pixel_y = 11
	},
/obj/item/stamp/denied{
	pixel_x = 9;
	pixel_y = 7
	},
/turf/open/floor/carpet/royalblack,
/area/misc/condo)
"KI" = (
/turf/closed/indestructible/fakeglass,
/area/misc/condo)
"La" = (
/turf/closed/indestructible/syndicate,
/area/misc/condo)
"MX" = (
/obj/structure/chair/comfy{
	color = "#DD2211";
	dir = 8
	},
/obj/effect/turf_decal/siding/thinplating_new/dark{
	dir = 4
	},
/turf/open/floor/carpet/royalblack,
/area/misc/condo)
"Nx" = (
/obj/effect/turf_decal/skyrat_decals/syndicate/bottom/middle,
/obj/structure/table/reinforced/plastitaniumglass,
/obj/item/sign/flag/syndicate{
	pixel_y = 3
	},
/turf/open/floor/mineral/plastitanium/red,
/area/misc/condo)
"Pk" = (
/obj/effect/turf_decal/siding/thinplating_new/dark/corner{
	dir = 8
	},
/obj/structure/railing/corner{
	dir = 8
	},
/turf/open/floor/wood/large,
/area/misc/condo)
"PC" = (
/obj/effect/turf_decal/trimline/dark_red/filled/line{
	dir = 6
	},
/obj/item/kirbyplants/organic/plant22,
/turf/open/indestructible/dark/textured,
/area/misc/condo)
"QZ" = (
/obj/effect/turf_decal/siding/thinplating_new/dark{
	dir = 6
	},
/obj/structure/railing/unbreakable{
	dir = 6
	},
/obj/structure/showcase/cyborg{
	desc = "A stand with the empty body of a Cybersun cyborg bolted to it.";
	dir = 4;
	icon = 'icons/mob/silicon/robots.dmi';
	icon_state = "synd_sec";
	name = "syndicate cyborg showcase";
	pixel_x = -6
	},
/turf/open/floor/mineral/plastitanium/red,
/area/misc/condo)
"St" = (
/obj/effect/turf_decal/siding/thinplating_new/dark{
	dir = 6
	},
/turf/open/floor/wood/large,
/area/misc/condo)
"SX" = (
/obj/effect/turf_decal/siding/thinplating_new/dark{
	dir = 8
	},
/obj/effect/turf_decal/trimline/dark_red/filled/corner{
	dir = 4
	},
/obj/machinery/light/floor,
/turf/open/indestructible/dark/textured,
/area/misc/condo)
"TA" = (
/obj/effect/turf_decal/skyrat_decals/syndicate/bottom/right,
/obj/structure/table/reinforced/plastitaniumglass,
/obj/item/paper_bin{
	pixel_y = 4
	},
/obj/item/pen/fountain{
	pixel_y = 5
	},
/turf/open/floor/mineral/plastitanium/red,
/area/misc/condo)
"TD" = (
/obj/effect/turf_decal/siding/thinplating_new/dark{
	dir = 8
	},
/obj/structure/railing/unbreakable{
	dir = 8
	},
/turf/open/floor/wood/large,
/area/misc/condo)
"TG" = (
/obj/effect/turf_decal/siding/thinplating_new/dark{
	dir = 1
	},
/turf/open/floor/wood/large,
/area/misc/condo)
"TO" = (
/turf/open/floor/carpet/black,
/area/misc/condo)
"TS" = (
/obj/structure/railing/unbreakable,
/turf/open/floor/iron/stairs/right{
	dir = 8
	},
/area/misc/condo)
"Ub" = (
/obj/effect/turf_decal/siding/thinplating_new/dark/corner{
	dir = 1
	},
/obj/structure/railing/corner{
	dir = 1
	},
/turf/open/floor/wood/large,
/area/misc/condo)
"Vk" = (
/obj/structure/sign/flag/syndicate/directional/east,
/obj/effect/turf_decal/siding/thinplating_new/dark{
	dir = 6
	},
/turf/open/floor/wood/large,
/area/misc/condo)
"VN" = (
/obj/machinery/light/floor,
/turf/open/indestructible/dark/textured,
/area/misc/condo)
"VS" = (
/obj/structure/secure_safe/directional/north,
/obj/effect/turf_decal/siding/thinplating_new/dark{
	dir = 5
	},
/turf/open/floor/wood/large,
/area/misc/condo)
"VV" = (
/obj/item/reagent_containers/cup/glass/bottle/vodka/badminka{
	pixel_y = 20
	},
/obj/item/reagent_containers/cup/glass/drinkingglass/shotglass{
	pixel_x = -8;
	pixel_y = 7
	},
/obj/item/reagent_containers/cup/glass/drinkingglass/shotglass{
	pixel_x = 8;
	pixel_y = 7
	},
/obj/item/reagent_containers/cup/glass/drinkingglass/shotglass{
	pixel_y = 2
	},
/obj/structure/table/reinforced/plastitaniumglass,
/turf/open/indestructible/dark/textured,
/area/misc/condo)
"VZ" = (
/obj/effect/turf_decal/trimline/neutral/filled/line{
	dir = 1
	},
/obj/effect/turf_decal/trimline/dark_red/filled/warning{
	dir = 1
	},
/turf/open/indestructible/dark/textured,
/area/misc/condo)
"XF" = (
/obj/effect/turf_decal/delivery,
/obj/machinery/suit_storage_unit,
/turf/open/indestructible/dark/textured{
	icon_state = "engine"
	},
/area/misc/condo)
"XL" = (
/obj/effect/turf_decal/skyrat_decals/syndicate/bottom/left,
/obj/structure/table/reinforced/plastitaniumglass,
/obj/item/folder/red{
	pixel_x = 4;
	pixel_y = 1
	},
/obj/item/pen/fountain{
	pixel_x = 4;
	pixel_y = 1
	},
/obj/item/reagent_containers/cup/glass/coffee/colonial{
	pixel_x = -7;
	pixel_y = 3
	},
/turf/open/floor/mineral/plastitanium/red,
/area/misc/condo)
"XR" = (
/obj/effect/turf_decal/siding/thinplating_new/dark{
	dir = 4
	},
/obj/machinery/light/floor,
/turf/open/indestructible/dark/textured,
/area/misc/condo)
"XW" = (
/obj/effect/turf_decal/siding/thinplating_new/dark{
	dir = 1
	},
/turf/closed/indestructible/syndicate,
/area/misc/condo)
"Zc" = (
/obj/effect/turf_decal/trimline/dark_red/filled/line,
/turf/open/indestructible/dark/textured,
/area/misc/condo)
"Zf" = (
/obj/effect/turf_decal/siding/thinplating_new/dark/corner,
/turf/open/floor/wood/large,
/area/misc/condo)

(1,1,1) = {"
La
La
La
La
La
La
KI
AJ
KI
La
La
La
La
La
La
"}
(2,1,1) = {"
La
La
La
La
La
DL
yS
TO
aU
IT
La
La
La
La
La
"}
(3,1,1) = {"
La
La
La
La
La
KI
En
gN
TS
KI
La
La
La
La
La
"}
(4,1,1) = {"
La
La
La
La
uK
dX
JB
EH
kz
gP
aK
XW
La
La
La
"}
(5,1,1) = {"
La
La
wz
QZ
tD
nt
yf
XR
yf
Av
Zc
sc
mQ
La
La
"}
(6,1,1) = {"
La
La
gL
EH
ep
vy
ye
ff
XL
tb
he
EH
zp
La
La
"}
(7,1,1) = {"
La
AJ
VZ
VN
FQ
vy
zb
hn
Nx
tb
FQ
VN
FM
AJ
La
"}
(8,1,1) = {"
La
La
ce
ua
ax
vy
wX
tH
TA
tb
Gp
ua
jQ
La
La
"}
(9,1,1) = {"
La
La
dt
rS
yX
tq
SX
De
bJ
bp
cj
fi
iw
La
La
"}
(10,1,1) = {"
La
La
La
La
mB
TS
Gu
ua
PC
En
mV
La
La
La
La
"}
(11,1,1) = {"
La
La
La
tv
TG
Pk
TD
TD
TD
Ub
qV
HZ
La
La
La
"}
(12,1,1) = {"
La
La
La
BQ
Aa
iL
qf
gs
JN
Zf
Vk
XF
La
La
La
"}
(13,1,1) = {"
La
La
La
La
La
VS
FS
MX
FS
St
La
La
La
La
La
"}
(14,1,1) = {"
fh
hQ
hQ
hQ
KI
KI
VV
FQ
qR
KI
KI
hQ
hQ
hQ
fh
"}
(15,1,1) = {"
fh
hQ
hQ
hQ
hQ
KI
KI
KI
KI
KI
hQ
hQ
hQ
hQ
fh
"}
(16,1,1) = {"
fh
fh
fh
fh
fh
fh
fh
fh
fh
fh
fh
fh
fh
fh
fh
"}
