//MAP CONVERTED BY dmm2tgm.py THIS HEADER COMMENT PREVENTS RECONVERSION, DO NOT REMOVE
"gU" = (
/obj/structure/flora/tree/pine,
/turf/open/floor/fake_snow/safe,
/area/misc/condo)
"ic" = (
/obj/structure/flora/bush/snow/style_4,
/obj/effect/turf_decal/weather/snow/corner{
	dir = 8
	},
/turf/open/floor/fake_snow/safe,
/area/misc/condo)
"jp" = (
/obj/structure/flora/bush/snow/style_4,
/obj/structure/flora/tree/pine,
/turf/open/floor/fake_snow/safe,
/area/misc/condo)
"jA" = (
/obj/structure/bonfire/prelit,
/obj/effect/turf_decal/weather/snow,
/turf/open/misc/dirt/jungle,
/area/misc/condo)
"jS" = (
/obj/effect/turf_decal/siding/wood{
	dir = 4
	},
/turf/open/floor/wood/tile,
/area/misc/condo)
"kD" = (
/obj/structure/closet/crate/wooden,
/obj/item/clothing/suit/modern_winter,
/obj/item/clothing/suit/modern_winter,
/obj/item/clothing/shoes/winterboots,
/obj/item/clothing/shoes/winterboots,
/obj/item/clothing/head/costume/ushanka,
/obj/item/clothing/head/costume/ushanka,
/obj/item/clothing/head/costume/ushanka/frosty,
/obj/item/clothing/head/costume/ushanka/frosty,
/obj/item/clothing/mask/gas,
/obj/item/clothing/mask/gas,
/obj/item/tank/internals/emergency_oxygen,
/obj/item/tank/internals/emergency_oxygen,
/obj/item/clothing/under/costume/soviet,
/obj/item/clothing/under/costume/soviet,
/turf/open/floor/fake_snow/safe,
/area/misc/condo)
"oE" = (
/obj/effect/turf_decal/siding/wood{
	dir = 1
	},
/obj/item/stack/sheet/mineral/wood/fifty{
	pixel_x = 8;
	pixel_y = -5
	},
/obj/item/assembly/igniter{
	pixel_x = -6;
	pixel_y = -6
	},
/obj/structure/fireplace,
/turf/open/floor/wood/tile,
/area/misc/condo)
"pb" = (
/obj/structure/flora/grass/both/style_random,
/turf/open/floor/fake_snow/safe,
/area/misc/condo)
"pc" = (
/obj/effect/spawner/structure/window/ice,
/obj/structure/barricade/wooden/crude/snow,
/turf/open/floor/fake_snow/safe,
/area/misc/condo)
"pj" = (
/obj/structure/chair/sofa/bench/left{
	dir = 4;
	color = "#76502e";
	name = "Lover's Watch"
	},
/turf/open/floor/fake_snow/safe,
/area/misc/condo)
"qe" = (
/obj/effect/decal/remains/plasma,
/turf/open/floor/fakeice/slippery,
/area/misc/condo)
"sq" = (
/mob/living/basic/pet/penguin/baby/permanent/snowdin,
/turf/open/floor/fake_snow/safe,
/area/misc/condo)
"sZ" = (
/obj/effect/spawner/structure/window/ice,
/obj/structure/barricade/wooden/crude/snow,
/obj/structure/curtain/bounty/start_closed,
/turf/open/floor/fake_snow/safe,
/area/misc/condo)
"tX" = (
/obj/effect/turf_decal/siding/wood{
	dir = 1
	},
/obj/effect/turf_decal/siding/wood{
	dir = 8
	},
/turf/open/floor/wood/tile,
/area/misc/condo)
"vd" = (
/turf/open/floor/wood/tile,
/area/misc/condo)
"vX" = (
/obj/effect/turf_decal/weather/snow/corner{
	dir = 8
	},
/turf/open/floor/fake_snow/safe,
/area/misc/condo)
"wb" = (
/obj/structure/table/wood/shuttle_bar,
/obj/effect/turf_decal/siding/wood,
/obj/item/flashlight/lantern/on{
	pixel_x = -5;
	pixel_y = 15
	},
/obj/item/reagent_containers/cup/glass/bottle/vodka{
	pixel_x = 8;
	pixel_y = 17
	},
/obj/item/reagent_containers/cup/glass/drinkingglass/shotglass{
	pixel_x = 2;
	pixel_y = 3
	},
/obj/item/reagent_containers/cup/glass/drinkingglass/shotglass{
	pixel_x = -7;
	pixel_y = 0
	},
/turf/open/floor/wood/tile,
/area/misc/condo)
"wJ" = (
/obj/effect/turf_decal/weather/snow/corner,
/turf/open/floor/fake_snow/safe,
/area/misc/condo)
"yp" = (
/obj/structure/chair/sofa/bench/right{
	dir = 4;
	color = "#76502e";
	name = "Lover's Watch"
	},
/obj/structure/railing/wooden_fencing,
/turf/open/floor/fake_snow/safe,
/area/misc/condo)
"yJ" = (
/turf/open/floor/plating/snowed/smoothed{
	planetary_atmos = 0;
	initial_gas_mix = "o2=22;n2=82;TEMP=293.15"
	},
/area/misc/condo)
"yW" = (
/turf/closed/indestructible/hoteldoor/fakedoor{
	icon = 'icons/obj/doors/mineral_doors.dmi';
	icon_state = "wood"
	},
/area/misc/condo)
"zd" = (
/obj/structure/mineral_door/wood,
/obj/effect/turf_decal/weather/snow,
/turf/open/floor/fake_snow/safe,
/area/misc/condo)
"Ac" = (
/turf/closed/indestructible/rock/snow/ice/ore,
/area/misc/condo)
"Bf" = (
/obj/structure/railing/wooden_fencing{
	dir = 4
	},
/obj/structure/railing/wooden_fencing,
/turf/open/floor/fake_snow/safe,
/area/misc/condo)
"Dl" = (
/obj/structure/chair/wood/wings{
	dir = 8
	},
/obj/effect/turf_decal/siding/wood,
/obj/effect/turf_decal/siding/wood{
	dir = 4
	},
/turf/open/floor/wood/tile,
/area/misc/condo)
"EV" = (
/turf/open/floor/fake_snow/safe,
/area/misc/condo)
"Fy" = (
/obj/structure/flora/tree/dead/style_random,
/turf/open/floor/fake_snow/safe,
/area/misc/condo)
"Gz" = (
/obj/structure/flora/bush/snow/style_4,
/turf/open/floor/fake_snow/safe,
/area/misc/condo)
"GC" = (
/obj/structure/chair/wood{
	dir = 4
	},
/obj/effect/turf_decal/siding/wood{
	dir = 8
	},
/obj/effect/turf_decal/siding/wood,
/turf/open/floor/wood/tile,
/area/misc/condo)
"GQ" = (
/obj/effect/turf_decal/weather/snow/corner,
/turf/closed/indestructible/rock/snow/ice/ore,
/area/misc/condo)
"GW" = (
/obj/structure/barricade/wooden/snowed,
/turf/open/floor/fake_snow/safe,
/area/misc/condo)
"HK" = (
/obj/structure/flora/bush/snow/style_random,
/mob/living/basic/pet/penguin/baby/permanent/snowdin,
/turf/open/floor/fake_snow/safe,
/area/misc/condo)
"HP" = (
/obj/item/flashlight/lantern/jade,
/turf/open/floor/fake_snow/safe,
/area/misc/condo)
"IE" = (
/obj/structure/flora/tree/pine/style_random,
/turf/open/floor/fake_snow/safe,
/area/misc/condo)
"Lg" = (
/obj/effect/turf_decal/siding/wood{
	dir = 8
	},
/obj/structure/bed/double{
	dir = 1
	},
/obj/item/bedsheet/runtime/double{
	dir = 1
	},
/obj/item/toy/plush/skyrat/snow_owl,
/obj/machinery/room_controller/directional/west,
/turf/open/floor/wood/tile,
/area/misc/condo)
"Ln" = (
/turf/closed/indestructible/wood,
/area/misc/condo)
"LP" = (
/obj/structure/railing/wooden_fencing{
	dir = 4
	},
/turf/open/floor/fake_snow/safe,
/area/misc/condo)
"NZ" = (
/obj/effect/turf_decal/siding/wood{
	dir = 1
	},
/obj/effect/turf_decal/siding/wood{
	dir = 4
	},
/obj/item/storage/box/colonial_rations{
	pixel_x = 7;
	pixel_y = -6
	},
/obj/item/storage/box/colonial_rations{
	pixel_x = -6;
	pixel_y = 8
	},
/obj/item/storage/box/colonial_rations{
	pixel_x = -6;
	pixel_y = -7
	},
/obj/structure/rack/wooden,
/turf/open/floor/wood/tile,
/area/misc/condo)
"PB" = (
/obj/structure/sign/poster/contraband/soviet_propaganda,
/turf/closed/indestructible/wood,
/area/misc/condo)
"PS" = (
/obj/structure/barricade/wooden/snowed,
/obj/structure/curtain/bounty/start_closed,
/obj/effect/spawner/structure/window/ice,
/turf/open/floor/fake_snow/safe,
/area/misc/condo)
"Qf" = (
/turf/open/lava/plasma/biodome,
/area/misc/condo)
"Rf" = (
/obj/effect/turf_decal/siding/wood{
	dir = 8
	},
/turf/open/floor/wood/tile,
/area/misc/condo)
"We" = (
/obj/effect/turf_decal/weather/snow/corner,
/turf/open/floor/plating/snowed/smoothed{
	planetary_atmos = 0;
	initial_gas_mix = "o2=22;n2=82;TEMP=293.15"
	},
/area/misc/condo)
"Wn" = (
/obj/item/grown/log/tree,
/turf/open/floor/fake_snow/safe,
/area/misc/condo)
"Wr" = (
/turf/open/floor/fakeice/slippery,
/area/misc/condo)
"Wt" = (
/obj/effect/turf_decal/weather/snow/corner,
/obj/structure/statue/snow/snowman,
/turf/open/floor/fake_snow/safe,
/area/misc/condo)
"Wu" = (
/obj/machinery/vending/dorms{
	pixel_y = -10
	},
/turf/closed/indestructible/wood,
/area/misc/condo)
"XT" = (
/obj/structure/flora/grass/both/style_random,
/obj/effect/turf_decal/weather/snow/corner,
/obj/effect/overlay/light_snow,
/turf/open/floor/fake_snow/safe,
/area/misc/condo)
"Yt" = (
/obj/effect/turf_decal/weather/snow,
/turf/open/misc/dirt/jungle,
/area/misc/condo)
"ZS" = (
/obj/structure/flora/bush/snow/style_random,
/turf/open/floor/fake_snow/safe,
/area/misc/condo)

(1,1,1) = {"
Ac
Ac
Ac
Ac
Ac
Ac
Ac
Ac
Ac
Ac
Ac
Ac
Ac
Ac
Ac
"}
(2,1,1) = {"
Ac
Ac
Ac
EV
EV
Ac
Ac
GQ
Ln
yW
Ln
Ln
Ln
Ln
Ac
"}
(3,1,1) = {"
Ac
Ac
ZS
EV
Fy
EV
EV
wJ
Wu
tX
Lg
Rf
GC
Ln
Ac
"}
(4,1,1) = {"
Ac
EV
EV
EV
EV
EV
Fy
XT
Ln
oE
vd
vd
wb
sZ
Ac
"}
(5,1,1) = {"
Ac
EV
gU
EV
jp
EV
Wr
wJ
PS
NZ
jS
jS
Dl
pc
Ac
"}
(6,1,1) = {"
Ac
EV
EV
Yt
EV
EV
Fy
wJ
Ln
PB
zd
GW
Ln
Ln
Ac
"}
(7,1,1) = {"
Ac
gU
Yt
jA
Yt
Wr
Wt
ic
vX
kD
yJ
EV
EV
EV
Ac
"}
(8,1,1) = {"
Ac
EV
Wn
Yt
EV
Fy
We
yJ
pb
yJ
EV
EV
EV
gU
Ac
"}
(9,1,1) = {"
Ac
EV
pb
Wr
EV
EV
yJ
yJ
yJ
yJ
EV
gU
Wr
EV
Ac
"}
(10,1,1) = {"
Ac
EV
Fy
EV
Fy
EV
gU
Wr
EV
Fy
HP
pj
yp
Ac
Ac
"}
(11,1,1) = {"
Ac
pb
sq
EV
pb
EV
EV
Fy
EV
gU
LP
LP
Bf
Qf
Ac
"}
(12,1,1) = {"
Ac
gU
EV
Fy
EV
EV
Fy
EV
EV
Wr
Qf
Qf
Qf
Qf
Ac
"}
(13,1,1) = {"
Ac
EV
pb
EV
pb
EV
yJ
EV
gU
Qf
Qf
Qf
Qf
Ac
Ac
"}
(14,1,1) = {"
Ac
EV
IE
Wr
EV
gU
EV
pb
Wr
Qf
Qf
Qf
Qf
Qf
Ac
"}
(15,1,1) = {"
Ac
EV
GW
EV
EV
EV
Gz
EV
HK
qe
Qf
Qf
Qf
Ac
Ac
"}
(16,1,1) = {"
Ac
Ac
Ac
Ac
Ac
Ac
Ac
Ac
Ac
Ac
Ac
Ac
Ac
Ac
Ac
"}
