//MAP CONVERTED BY dmm2tgm.py THIS HEADER COMMENT PREVENTS RECONVERSION, DO NOT REMOVE
"a" = (
/turf/closed/wall/r_wall,
/area/station/command/heads_quarters/nt_rep)
"b" = (
/obj/machinery/atmospherics/pipe/smart/manifold4w/supply/hidden/layer4,
/obj/machinery/atmospherics/pipe/smart/manifold4w/scrubbers/hidden/layer2,
/obj/structure/cable,
/obj/machinery/power/apc/auto_name/directional/east,
/turf/open/floor/iron/dark,
/area/station/command/corporate_showroom)
"c" = (
/obj/machinery/modular_computer/preset/command,
/obj/structure/sign/flag/galfed/directional/north,
/turf/open/floor/carpet/green,
/area/station/command/heads_quarters/nt_rep)
"d" = (
/obj/effect/turf_decal/siding/wood,
/obj/structure/filingcabinet/security{
	pixel_x = 10
	},
/obj/structure/filingcabinet,
/obj/structure/filingcabinet/medical{
	pixel_x = -10
	},
/obj/machinery/light_switch/directional/north{
	pixel_x = 9;
	pixel_y = 24
	},
/obj/machinery/button/door/directional/north{
	pixel_x = 1;
	name = "Office Door Lock";
	id = "nt_rep_front_bolt";
	specialfunctions = 4;
	normaldoorcontrol = 1
	},
/obj/machinery/button/door/directional/north{
	pixel_x = -8;
	id = "nt_rep_front_priv";
	name = "Office Privacy Shutters"
	},
/turf/open/floor/carpet/green,
/area/station/command/heads_quarters/nt_rep)
"e" = (
/obj/machinery/atmospherics/pipe/smart/manifold4w/supply/hidden/layer4,
/obj/machinery/atmospherics/pipe/smart/manifold4w/scrubbers/hidden/layer2,
/obj/structure/cable,
/obj/machinery/firealarm/directional/south,
/obj/machinery/light_switch/directional/south{
	pixel_x = 10;
	pixel_y = -27
	},
/turf/open/floor/wood,
/area/station/command/heads_quarters/nt_rep)
"f" = (
/obj/structure/cable,
/obj/machinery/door/airlock/corporate{
	name = "NT Consultant's Office";
	id_tag = "nt_rep_front_bolt"
	},
/obj/machinery/atmospherics/pipe/smart/manifold4w/scrubbers/hidden/layer2,
/obj/machinery/atmospherics/pipe/smart/manifold4w/supply/hidden/layer4,
/obj/machinery/door/firedoor,
/obj/effect/mapping_helpers/airlock/access/all/cent_com/rep_door,
/obj/machinery/door/poddoor/shutters/preopen{
	id = "nt_rep_front_priv";
	name = "Tactical Privacy Shutter";
	desc = "Heavy duty, airtight mechanical shutters for the most demanding enterprise resource planning."
	},
/obj/effect/mapping_helpers/airlock/unres{
	dir = 4
	},
/turf/open/floor/wood,
/area/station/command/heads_quarters/nt_rep)
"g" = (
/obj/effect/turf_decal/siding/dark_blue{
	dir = 1
	},
/obj/machinery/atmospherics/pipe/smart/manifold4w/supply/hidden/layer4,
/obj/structure/cable,
/obj/machinery/atmospherics/pipe/smart/manifold4w/scrubbers/hidden/layer2,
/turf/open/floor/iron/dark,
/area/station/command/corporate_showroom)
"h" = (
/obj/machinery/atmospherics/pipe/smart/manifold4w/supply/hidden/layer4,
/obj/machinery/atmospherics/pipe/smart/manifold4w/scrubbers/hidden/layer2,
/obj/structure/cable,
/obj/machinery/light/warm/directional/south,
/turf/open/floor/wood,
/area/station/command/heads_quarters/nt_rep)
"i" = (
/obj/machinery/door/airlock/corporate{
	name = "NT Consultant's Office"
	},
/obj/effect/mapping_helpers/airlock/access/all/cent_com/rep_door,
/obj/effect/mapping_helpers/airlock/unres{
	dir = 4
	},
/obj/machinery/atmospherics/pipe/smart/manifold4w/supply/hidden/layer4,
/obj/machinery/atmospherics/pipe/smart/manifold4w/scrubbers/hidden/layer2,
/obj/structure/cable,
/turf/open/floor/carpet/green,
/area/station/command/heads_quarters/nt_rep)
"j" = (
/obj/machinery/fax{
	fax_name = "Nanotrasen Consultant's Office";
	name = "Nanotrasen Consultant's Fax Machine"
	},
/obj/structure/table/wood,
/obj/structure/sign/calendar/directional/north,
/turf/open/floor/carpet/green,
/area/station/command/heads_quarters/nt_rep)
"k" = (
/obj/machinery/atmospherics/pipe/smart/manifold4w/supply/hidden/layer4,
/obj/machinery/atmospherics/pipe/smart/manifold4w/scrubbers/hidden/layer2,
/obj/structure/cable,
/obj/machinery/button/door/directional/south{
	pixel_x = -2;
	name = "Quarters Door Lock";
	normaldoorcontrol = 1;
	specialfunctions = 4;
	id = "nt_rep_rear_bolt"
	},
/obj/machinery/button/door/directional/south{
	pixel_x = 7;
	id = "nt_rep_rear_priv";
	name = "Quarters Privacy Shutters"
	},
/obj/machinery/light_switch/directional/south{
	pixel_x = -10;
	pixel_y = -24
	},
/turf/open/floor/carpet/green,
/area/station/command/heads_quarters/nt_rep)
"l" = (
/obj/effect/spawner/structure/window/reinforced,
/obj/structure/cable,
/obj/machinery/door/poddoor/shutters/preopen{
	id = "nt_rep_front_priv";
	name = "Tactical Privacy Shutter";
	desc = "Heavy duty, airtight mechanical shutters for the most demanding enterprise resource planning."
	},
/turf/open/floor/plating,
/area/station/command/heads_quarters/nt_rep)
"m" = (
/obj/machinery/light/directional/east,
/obj/effect/turf_decal/tile/dark_blue/half/contrasted{
	dir = 4
	},
/turf/open/floor/iron,
/area/station/hallway/secondary/command)
"n" = (
/obj/structure/sign/picture_frame,
/turf/closed/wall,
/area/station/command/heads_quarters/nt_rep)
"o" = (
/obj/machinery/photocopier/prebuilt,
/obj/item/radio/intercom/directional/east,
/turf/open/floor/wood,
/area/station/command/heads_quarters/nt_rep)
"p" = (
/obj/structure/table/wood,
/obj/structure/sign/flag/nanotrasen/directional/south,
/obj/machinery/light/warm/directional/south,
/turf/open/floor/wood,
/area/station/command/heads_quarters/nt_rep)
"q" = (
/obj/machinery/atmospherics/pipe/smart/manifold4w/scrubbers/hidden/layer2,
/obj/structure/cable,
/obj/machinery/atmospherics/pipe/smart/manifold4w/supply/hidden/layer4,
/turf/open/floor/wood,
/area/station/command/heads_quarters/nt_rep)
"r" = (
/obj/structure/cable,
/obj/structure/sign/picture_frame,
/turf/closed/wall/r_wall,
/area/station/command/heads_quarters/nt_rep)
"s" = (
/obj/machinery/atmospherics/pipe/smart/manifold4w/scrubbers/hidden/layer2,
/obj/structure/cable,
/obj/machinery/atmospherics/pipe/smart/manifold4w/supply/hidden/layer4,
/obj/effect/landmark/start/nanotrasen_crew_trainer,
/turf/open/floor/wood,
/area/station/command/heads_quarters/nt_rep)
"t" = (
/obj/machinery/atmospherics/pipe/smart/manifold4w/supply/hidden/layer4,
/obj/machinery/atmospherics/pipe/smart/manifold4w/scrubbers/hidden/layer2,
/obj/structure/cable,
/obj/machinery/power/apc/auto_name/directional/south,
/turf/open/floor/wood,
/area/station/command/heads_quarters/nt_rep)
"u" = (
/obj/structure/table/wood,
/obj/item/paper_bin/carbon{
	pixel_y = 4;
	pixel_x = -4
	},
/obj/item/pen/fountain{
	pixel_x = -4;
	pixel_y = 6
	},
/obj/item/stamp{
	pixel_x = 8;
	pixel_y = 8
	},
/obj/item/stamp/denied{
	pixel_x = 8
	},
/obj/item/stamp/centcom{
	pixel_y = 10
	},
/obj/machinery/atmospherics/pipe/smart/manifold4w/scrubbers/hidden/layer2,
/obj/structure/cable,
/obj/machinery/atmospherics/pipe/smart/manifold4w/supply/hidden/layer4,
/turf/open/floor/carpet/green,
/area/station/command/heads_quarters/nt_rep)
"v" = (
/obj/structure/table/wood,
/turf/open/floor/carpet/green,
/area/station/command/heads_quarters/nt_rep)
"w" = (
/obj/effect/turf_decal/siding/dark_blue{
	dir = 1
	},
/obj/machinery/light/directional/east,
/obj/effect/turf_decal/siding/dark_blue{
	dir = 1
	},
/obj/machinery/atmospherics/pipe/smart/manifold4w/supply/hidden/layer4,
/obj/structure/cable,
/obj/machinery/atmospherics/pipe/smart/manifold4w/scrubbers/hidden/layer2,
/obj/machinery/firealarm/directional/east,
/turf/open/floor/iron/dark,
/area/station/command/corporate_showroom)
"x" = (
/obj/structure/chair/office/tactical{
	dir = 8
	},
/obj/effect/landmark/start/nanotrasen_consultant,
/turf/open/floor/carpet/green,
/area/station/command/heads_quarters/nt_rep)
"y" = (
/obj/structure/chair/comfy/black{
	dir = 8
	},
/turf/open/floor/wood,
/area/station/command/heads_quarters/nt_rep)
"z" = (
/obj/item/kirbyplants/random,
/turf/open/floor/wood,
/area/station/command/heads_quarters/nt_rep)
"A" = (
/obj/machinery/vending/boozeomat,
/turf/closed/wall/r_wall,
/area/station/command/heads_quarters/nt_rep)
"B" = (
/obj/machinery/atmospherics/pipe/smart/manifold4w/supply/hidden/layer4,
/obj/machinery/atmospherics/pipe/smart/manifold4w/scrubbers/hidden/layer2,
/turf/open/floor/iron/dark,
/area/station/command/corporate_showroom)
"C" = (
/obj/machinery/atmospherics/pipe/smart/manifold4w/supply/hidden/layer4,
/obj/machinery/atmospherics/pipe/smart/manifold4w/scrubbers/hidden/layer2,
/obj/structure/cable,
/obj/structure/table/wood,
/obj/item/table_clock{
	pixel_y = 16;
	pixel_x = 7
	},
/turf/open/floor/carpet/green,
/area/station/command/heads_quarters/nt_rep)
"D" = (
/obj/effect/turf_decal/tile/dark_blue/half/contrasted{
	dir = 4
	},
/turf/open/floor/iron,
/area/station/hallway/secondary/command)
"E" = (
/obj/structure/chair/comfy/beige{
	dir = 1
	},
/turf/open/floor/wood,
/area/station/command/heads_quarters/nt_rep)
"F" = (
/obj/structure/closet/secure_closet/nanotrasen_consultant,
/obj/machinery/atmospherics/components/unary/vent_scrubber/on/layer2,
/obj/item/assembly/flash/handheld,
/obj/item/radio/intercom/directional/north,
/turf/open/floor/carpet/green,
/area/station/command/heads_quarters/nt_rep)
"G" = (
/obj/structure/table/wood,
/obj/machinery/light/small/blacklight/directional/west,
/turf/open/floor/carpet/green,
/area/station/command/heads_quarters/nt_rep)
"I" = (
/obj/machinery/newscaster/directional/north,
/obj/structure/cable,
/obj/machinery/atmospherics/components/unary/vent_scrubber/on/layer2{
	dir = 8
	},
/turf/open/floor/wood,
/area/station/command/heads_quarters/nt_rep)
"J" = (
/obj/structure/chair/comfy/black{
	dir = 4
	},
/obj/effect/landmark/start/nanotrasen_consultant,
/turf/open/floor/wood,
/area/station/command/heads_quarters/nt_rep)
"K" = (
/obj/machinery/atmospherics/components/unary/vent_pump/on/layer4{
	dir = 4
	},
/turf/open/floor/iron/dark,
/area/station/command/corporate_showroom)
"L" = (
/obj/structure/cable,
/obj/machinery/door/airlock/corporate{
	name = "NT Consultant's Back Door";
	id_tag = "nt_rep_rear_bolt"
	},
/obj/machinery/atmospherics/pipe/smart/manifold4w/scrubbers/hidden/layer2,
/obj/machinery/atmospherics/pipe/smart/manifold4w/supply/hidden/layer4,
/obj/machinery/door/firedoor,
/obj/effect/mapping_helpers/airlock/access/all/cent_com/rep_door,
/obj/effect/mapping_helpers/airlock/unres,
/turf/open/floor/wood,
/area/station/command/corporate_showroom)
"M" = (
/obj/machinery/atmospherics/pipe/smart/manifold4w/scrubbers/hidden/layer2,
/obj/structure/cable,
/obj/machinery/atmospherics/pipe/smart/manifold4w/supply/hidden/layer4,
/obj/machinery/light/warm/directional/north,
/turf/open/floor/wood,
/area/station/command/heads_quarters/nt_rep)
"N" = (
/obj/effect/spawner/structure/window/reinforced,
/obj/structure/cable,
/obj/machinery/door/poddoor/shutters/preopen{
	id = "nt_rep_rear_priv";
	name = "Tactical Privacy Shutter";
	desc = "Heavy duty, airtight mechanical shutters for the most demanding enterprise resource planning."
	},
/turf/open/floor/plating,
/area/station/command/heads_quarters/nt_rep)
"O" = (
/turf/open/floor/carpet/green,
/area/station/command/heads_quarters/nt_rep)
"P" = (
/obj/structure/cable,
/obj/machinery/atmospherics/pipe/smart/manifold4w/scrubbers/hidden/layer2,
/obj/machinery/atmospherics/pipe/smart/manifold4w/supply/hidden/layer4,
/obj/effect/turf_decal/tile/dark_blue/half/contrasted{
	dir = 4
	},
/obj/structure/disposalpipe/segment,
/turf/open/floor/iron,
/area/station/hallway/secondary/command)
"Q" = (
/obj/structure/bed/double{
	dir = 8
	},
/obj/item/bedsheet/centcom/double,
/obj/effect/landmark/start/nanotrasen_consultant,
/obj/structure/cable,
/turf/open/floor/carpet/green,
/area/station/command/heads_quarters/nt_rep)
"R" = (
/turf/template_noop,
/area/template_noop)
"S" = (
/obj/structure/cable,
/obj/effect/landmark/event_spawn,
/obj/machinery/atmospherics/pipe/smart/manifold4w/scrubbers/hidden/layer2,
/obj/machinery/atmospherics/pipe/smart/manifold4w/supply/hidden/layer4,
/obj/effect/turf_decal/siding/dark_blue{
	dir = 1
	},
/turf/open/floor/iron/dark,
/area/station/command/corporate_showroom)
"T" = (
/obj/machinery/atmospherics/components/unary/vent_pump/on/layer4{
	dir = 8
	},
/obj/structure/cable,
/obj/machinery/atmospherics/pipe/smart/manifold4w/scrubbers/hidden/layer2,
/turf/open/floor/wood,
/area/station/command/heads_quarters/nt_rep)
"U" = (
/turf/closed/wall/r_wall,
/area/station/command/corporate_showroom)
"V" = (
/obj/machinery/atmospherics/pipe/smart/manifold4w/scrubbers/hidden/layer2,
/obj/structure/cable,
/obj/machinery/atmospherics/pipe/smart/manifold4w/supply/hidden/layer4,
/obj/machinery/airalarm/directional/south,
/turf/open/floor/wood,
/area/station/command/heads_quarters/nt_rep)
"W" = (
/obj/effect/turf_decal/tile/dark_blue/half/contrasted{
	dir = 4
	},
/obj/item/radio/intercom/directional/east,
/turf/open/floor/iron,
/area/station/hallway/secondary/command)
"X" = (
/obj/structure/chair/comfy/black,
/obj/structure/cable,
/obj/machinery/atmospherics/pipe/smart/manifold4w/scrubbers/hidden/layer2,
/turf/open/floor/wood,
/area/station/command/heads_quarters/nt_rep)
"Y" = (
/obj/machinery/atmospherics/pipe/smart/manifold4w/supply/hidden/layer4,
/obj/machinery/atmospherics/pipe/smart/manifold4w/scrubbers/hidden/layer2,
/obj/structure/cable,
/obj/machinery/newscaster/directional/west,
/obj/effect/landmark/firealarm_sanity,
/turf/open/floor/carpet/green,
/area/station/command/heads_quarters/nt_rep)
"Z" = (
/turf/template_noop,
/area/station/command/corporate_showroom)

(1,1,1) = {"
R
R
R
W
D
D
D
P
m
R
"}
(2,1,1) = {"
R
R
a
a
l
l
l
f
a
R
"}
(3,1,1) = {"
R
Z
a
d
O
u
E
e
a
R
"}
(4,1,1) = {"
R
K
a
c
x
v
E
h
n
R
"}
(5,1,1) = {"
R
B
a
j
O
C
z
t
a
R
"}
(6,1,1) = {"
S
b
r
M
q
q
s
V
a
R
"}
(7,1,1) = {"
g
U
a
i
A
o
T
J
a
R
"}
(8,1,1) = {"
w
L
Y
k
a
a
X
p
a
R
"}
(9,1,1) = {"
R
U
F
Q
G
a
I
y
a
R
"}
(10,1,1) = {"
R
U
N
N
N
a
l
l
a
R
"}
(11,1,1) = {"
R
R
R
R
R
R
R
R
R
R
"}
