//MAP CONVERTED BY dmm2tgm.py THIS HEADER COMMENT PREVENTS RECONVERSION, DO NOT REMOVE
"aa" = (
/obj/machinery/atmospherics/pipe/smart/manifold4w/supply/hidden/layer4,
/obj/effect/turf_decal/siding/wood,
/obj/effect/landmark/start/nanotrasen_crew_trainer,
/turf/open/floor/wood/large,
/area/station/command/heads_quarters/nt_rep)
"ab" = (
/obj/effect/turf_decal/siding/wood{
	dir = 4
	},
/obj/effect/turf_decal/siding/wood{
	dir = 8
	},
/obj/structure/sign/poster/official/nanotrasen_logo/directional/west,
/turf/open/floor/wood/large,
/area/station/command/heads_quarters/nt_rep)
"ac" = (
/obj/structure/safe/floor,
/obj/item/clothing/accessory/medal/gold/nanotrasen_consultant,
/obj/item/clothing/accessory/medal/silver/bureaucracy,
/obj/item/clothing/accessory/medal/gold/ordom,
/turf/open/floor/carpet/executive,
/area/station/command/heads_quarters/nt_rep)
"ad" = (
/obj/machinery/atmospherics/pipe/smart/manifold4w/supply/hidden/layer4,
/obj/effect/turf_decal/siding/wood{
	dir = 5
	},
/obj/machinery/photocopier/prebuilt,
/obj/item/toy/plush/skyrat/ian/lisa{
	pixel_y = 11
	},
/turf/open/floor/wood/large,
/area/station/command/heads_quarters/nt_rep)
"ae" = (
/obj/effect/turf_decal/siding/wood/corner,
/obj/effect/turf_decal/siding/wood/corner{
	dir = 8
	},
/obj/structure/chair/office{
	dir = 8
	},
/obj/effect/landmark/start/nanotrasen_crew_trainer,
/turf/open/floor/wood/large,
/area/station/command/heads_quarters/nt_rep)
"af" = (
/obj/effect/turf_decal/siding/wood{
	dir = 5
	},
/obj/structure/hedge,
/turf/open/floor/wood/large,
/area/station/command/heads_quarters/nt_rep)
"ag" = (
/obj/machinery/atmospherics/pipe/smart/manifold4w/supply/hidden/layer4,
/obj/machinery/atmospherics/pipe/smart/manifold4w/scrubbers/hidden/layer2,
/obj/structure/cable,
/obj/machinery/light_switch/directional/east,
/obj/effect/turf_decal/siding/wood/end{
	dir = 4
	},
/turf/open/floor/wood/large,
/area/station/command/heads_quarters/nt_rep)
"ah" = (
/obj/machinery/keycard_auth/wall_mounted/directional/north,
/obj/structure/aquarium/prefilled,
/obj/item/reagent_containers/cup/fish_feed{
	pixel_y = 17;
	pixel_x = -3
	},
/turf/open/floor/carpet/executive,
/area/station/command/heads_quarters/nt_rep)
"ai" = (
/turf/template_noop,
/area/template_noop)
"aj" = (
/obj/structure/table/wood,
/obj/item/taperecorder{
	pixel_y = 2;
	pixel_x = -5
	},
/obj/item/tape{
	pixel_x = 4
	},
/obj/machinery/vending/boozeomat{
	pixel_y = -32;
	density = 0;
	req_access = list("cent_general")
	},
/obj/machinery/light/directional/south,
/turf/open/floor/carpet/royalblue,
/area/station/command/heads_quarters/nt_rep)
"ak" = (
/obj/item/paper_bin{
	pixel_y = 5;
	pixel_x = -4
	},
/obj/item/stamp{
	pixel_y = 12;
	pixel_x = 8
	},
/obj/item/stamp/denied{
	pixel_x = 8;
	pixel_y = 6
	},
/obj/structure/table/reinforced/titaniumglass,
/obj/item/stamp/nanotrasen{
	pixel_x = 8
	},
/obj/item/pen/fountain/nanotrasen{
	pixel_y = 5;
	pixel_x = -4
	},
/obj/machinery/requests_console/directional/east{
	name = "Nanotrasen Consultant's Requests Console";
	department = "Nanotrasen Consultant's Desk"
	},
/obj/effect/mapping_helpers/requests_console/announcement,
/obj/effect/mapping_helpers/requests_console/information,
/obj/effect/mapping_helpers/requests_console/assistance,
/turf/open/floor/carpet/executive,
/area/station/command/heads_quarters/nt_rep)
"al" = (
/obj/effect/turf_decal/siding/wood/corner{
	dir = 4
	},
/obj/effect/turf_decal/siding/wood{
	dir = 8
	},
/turf/open/floor/wood/large,
/area/station/command/heads_quarters/nt_rep)
"am" = (
/obj/effect/spawner/structure/window/reinforced,
/obj/structure/cable,
/obj/machinery/door/poddoor/shutters/preopen{
	id = "nt_rep_priv";
	dir = 4;
	name = "Privacy Shutters"
	},
/turf/open/floor/plating,
/area/station/command/heads_quarters/nt_rep)
"an" = (
/obj/structure/sign/calendar/directional/south,
/obj/machinery/light/warm/directional/south,
/obj/effect/turf_decal/siding/wood,
/obj/structure/closet/secure_closet/nanotrasen_crew_trainer,
/obj/item/storage/lunchbox/nanotrasen,
/turf/open/floor/wood/large,
/area/station/command/heads_quarters/nt_rep)
"ao" = (
/obj/structure/sign/clock/directional/north,
/obj/structure/closet/secure_closet/nanotrasen_consultant,
/turf/open/floor/carpet/executive,
/area/station/command/heads_quarters/nt_rep)
"aq" = (
/obj/effect/turf_decal/siding/wood/end{
	dir = 1
	},
/obj/machinery/button/door/directional/west{
	id = "nt_rep_priv";
	name = "Privacy Shutters Control";
	req_access = list("cent_general")
	},
/obj/structure/filingcabinet/employment{
	name = "employment forms filing cabinet"
	},
/obj/structure/filingcabinet/medical{
	pixel_x = -10;
	icon_state = "employmentcabinet";
	name = "medical records filing cabinet"
	},
/obj/structure/filingcabinet/security{
	pixel_x = 10;
	icon_state = "employmentcabinet";
	name = "security records filing cabinet"
	},
/turf/open/floor/wood/large,
/area/station/command/heads_quarters/nt_rep)
"ar" = (
/obj/machinery/atmospherics/pipe/smart/manifold4w/supply/hidden/layer4,
/obj/machinery/atmospherics/pipe/smart/manifold4w/scrubbers/hidden/layer2,
/obj/structure/cable,
/obj/effect/turf_decal/siding/wood{
	dir = 1
	},
/obj/effect/turf_decal/siding/wood/corner,
/turf/open/floor/wood/large,
/area/station/command/heads_quarters/nt_rep)
"as" = (
/obj/machinery/atmospherics/pipe/smart/manifold4w/supply/hidden/layer4,
/obj/machinery/atmospherics/pipe/smart/manifold4w/scrubbers/hidden/layer2,
/obj/effect/turf_decal/siding/wood/corner{
	dir = 4
	},
/turf/open/floor/wood/large,
/area/station/command/heads_quarters/nt_rep)
"at" = (
/turf/closed/wall/r_wall,
/area/station/command/heads_quarters/nt_rep)
"au" = (
/obj/structure/table/wood,
/obj/effect/spawner/random/bureaucracy/folder{
	spawn_random_offset = 1
	},
/turf/open/floor/carpet/royalblue,
/area/station/command/heads_quarters/nt_rep)
"av" = (
/obj/structure/hedge,
/obj/effect/turf_decal/siding/wood/end,
/turf/open/floor/wood/large,
/area/station/command/heads_quarters/nt_rep)
"aw" = (
/obj/effect/turf_decal/siding/wood{
	dir = 8
	},
/obj/structure/table/wood,
/obj/item/paper_bin{
	pixel_y = 5;
	pixel_x = -4
	},
/obj/item/pen{
	pixel_y = 5;
	pixel_x = -4
	},
/obj/item/stamp{
	pixel_y = 9;
	pixel_x = 8
	},
/obj/item/stamp/denied{
	pixel_x = 8;
	pixel_y = 2
	},
/obj/structure/window/reinforced/spawner/directional/west,
/turf/open/floor/wood/large,
/area/station/command/heads_quarters/nt_rep)
"ax" = (
/obj/machinery/firealarm/directional/south,
/obj/effect/turf_decal/siding/wood{
	dir = 10
	},
/obj/structure/table/wood,
/obj/item/clipboard{
	pixel_y = 3;
	pixel_x = 2
	},
/obj/item/folder/yellow{
	pixel_y = 1;
	pixel_x = -2
	},
/obj/structure/window/reinforced/spawner/directional/west,
/turf/open/floor/wood/large,
/area/station/command/heads_quarters/nt_rep)
"ay" = (
/obj/effect/turf_decal/siding/wood{
	dir = 1
	},
/obj/machinery/atmospherics/components/unary/vent_pump/on/layer4,
/turf/open/floor/wood/large,
/area/station/command/heads_quarters/nt_rep)
"az" = (
/obj/effect/turf_decal/trimline/blue/filled/line,
/obj/effect/turf_decal/trimline/dark/line,
/obj/structure/cable,
/obj/machinery/atmospherics/pipe/smart/manifold4w/supply/hidden/layer4,
/obj/machinery/atmospherics/pipe/smart/manifold4w/scrubbers/hidden/layer2,
/turf/open/floor/iron,
/area/station/hallway/primary/central)
"aA" = (
/obj/structure/table/reinforced/titaniumglass,
/obj/item/flashlight/lamp/green{
	pixel_y = 13;
	pixel_x = -6
	},
/obj/item/phone{
	pixel_x = -4;
	pixel_y = -1
	},
/obj/machinery/recharger{
	pixel_y = 3;
	pixel_x = 7
	},
/turf/open/floor/carpet/executive,
/area/station/command/heads_quarters/nt_rep)
"aB" = (
/turf/closed/wall/r_wall,
/area/station/maintenance/port/aft)
"aC" = (
/obj/machinery/atmospherics/pipe/smart/manifold4w/supply/hidden/layer4,
/obj/effect/turf_decal/siding/wood{
	dir = 1
	},
/turf/open/floor/wood/large,
/area/station/command/heads_quarters/nt_rep)
"aD" = (
/obj/machinery/atmospherics/components/unary/vent_scrubber/on/layer2{
	dir = 4
	},
/turf/open/floor/wood/large,
/area/station/command/heads_quarters/nt_rep)
"aE" = (
/obj/structure/chair/sofa/right/brown{
	dir = 8;
	color = "#462f1c"
	},
/turf/open/floor/carpet/royalblue,
/area/station/command/heads_quarters/nt_rep)
"aF" = (
/obj/machinery/modular_computer/preset/time_clock/directional/south,
/obj/effect/turf_decal/trimline/blue/filled/corner{
	dir = 8
	},
/obj/effect/turf_decal/trimline/dark/corner{
	dir = 8
	},
/obj/structure/cable,
/obj/machinery/atmospherics/pipe/smart/manifold4w/supply/hidden/layer4,
/obj/machinery/atmospherics/pipe/smart/manifold4w/scrubbers/hidden/layer2,
/turf/open/floor/iron,
/area/station/hallway/primary/central)
"aG" = (
/obj/effect/turf_decal/siding/wood{
	dir = 1
	},
/obj/structure/chair/wood{
	dir = 1
	},
/turf/open/floor/wood/large,
/area/station/command/heads_quarters/nt_rep)
"aH" = (
/obj/machinery/door/firedoor,
/obj/structure/cable,
/obj/machinery/atmospherics/pipe/smart/manifold4w/scrubbers/hidden/layer2,
/obj/machinery/atmospherics/pipe/smart/manifold4w/supply/hidden/layer4,
/obj/effect/mapping_helpers/airlock/access/all/cent_com/rep_door,
/obj/machinery/door/airlock/corporate{
	name = "Nanotrasen Internal Affairs Office"
	},
/obj/effect/landmark/navigate_destination/autoname,
/obj/effect/mapping_helpers/airlock/unres,
/turf/open/floor/iron/dark/smooth_large,
/area/station/command/heads_quarters/nt_rep)
"aI" = (
/obj/effect/turf_decal/siding/wood{
	dir = 1
	},
/turf/open/floor/wood/large,
/area/station/command/heads_quarters/nt_rep)
"aJ" = (
/obj/structure/chair/sofa/left/brown{
	dir = 8;
	color = "#462f1c"
	},
/obj/structure/sign/poster/official/enlist/directional/south,
/obj/machinery/camera/autoname/directional/south,
/turf/open/floor/carpet/royalblue,
/area/station/command/heads_quarters/nt_rep)
"aK" = (
/obj/machinery/door/airlock/maintenance,
/obj/effect/mapping_helpers/airlock/access/all/cent_com/rep_door,
/turf/open/floor/iron/dark/smooth_large,
/area/station/command/heads_quarters/nt_rep)
"aL" = (
/obj/structure/chair/comfy/brown,
/obj/effect/landmark/start/nanotrasen_consultant,
/turf/open/floor/carpet/executive,
/area/station/command/heads_quarters/nt_rep)
"aM" = (
/obj/structure/extinguisher_cabinet/directional/south,
/obj/machinery/power/apc/auto_name/directional/east,
/obj/structure/cable,
/obj/structure/hedge,
/obj/effect/turf_decal/siding/wood{
	dir = 6
	},
/turf/open/floor/wood/large,
/area/station/command/heads_quarters/nt_rep)
"aN" = (
/obj/effect/turf_decal/siding/wood{
	dir = 4
	},
/obj/effect/turf_decal/siding/wood{
	dir = 8
	},
/obj/structure/noticeboard/directional/west{
	name = "Nanotrasen Consultant's Notice Board"
	},
/obj/machinery/light/directional/west,
/turf/open/floor/wood/large,
/area/station/command/heads_quarters/nt_rep)
"aO" = (
/obj/structure/table/reinforced/titaniumglass,
/obj/item/clipboard{
	pixel_y = 3;
	pixel_x = -5
	},
/obj/item/folder/blue{
	pixel_y = 2;
	pixel_x = -4
	},
/obj/item/reagent_containers/cup/glass/mug/nanotrasen{
	pixel_y = 11;
	pixel_x = 11
	},
/obj/item/sign/flag/nanotrasen{
	pixel_x = 5
	},
/turf/open/floor/carpet/executive,
/area/station/command/heads_quarters/nt_rep)
"aP" = (
/obj/machinery/status_display/evac/directional/north,
/obj/machinery/fax{
	fax_name = "Nanotrasen Consultant's Office";
	name = "Nanotrasen Consultant's Fax Machine"
	},
/obj/structure/table/wood/fancy/blue,
/turf/open/floor/carpet/executive,
/area/station/command/heads_quarters/nt_rep)
"aQ" = (
/obj/effect/turf_decal/siding/wood,
/obj/machinery/atmospherics/pipe/smart/manifold4w/supply/hidden/layer4,
/turf/open/floor/wood/large,
/area/station/command/heads_quarters/nt_rep)
"aR" = (
/obj/machinery/modular_computer/preset/command{
	dir = 8
	},
/turf/open/floor/carpet/executive,
/area/station/command/heads_quarters/nt_rep)
"aS" = (
/obj/structure/chair/sofa/left/brown{
	dir = 4;
	color = "#462f1c"
	},
/turf/open/floor/carpet/royalblue,
/area/station/command/heads_quarters/nt_rep)
"aT" = (
/obj/effect/turf_decal/siding/wood/end,
/obj/machinery/status_display/ai/directional/south,
/obj/machinery/computer/station_goal{
	dir = 1
	},
/turf/open/floor/wood/large,
/area/station/command/heads_quarters/nt_rep)
"aU" = (
/obj/structure/chair/sofa/right/brown{
	dir = 4;
	color = "#462f1c"
	},
/obj/machinery/airalarm/directional/west,
/obj/item/radio/intercom/directional/south,
/turf/open/floor/carpet/royalblue,
/area/station/command/heads_quarters/nt_rep)
"aV" = (
/obj/structure/sign/directions/dorms/directional/west{
	pixel_y = 8
	},
/obj/structure/sign/directions/evac/directional/west,
/obj/structure/sign/directions/engineering/directional/west{
	pixel_y = -8;
	dir = 2
	},
/obj/machinery/atmospherics/pipe/smart/manifold4w/scrubbers/hidden/layer2,
/obj/machinery/atmospherics/pipe/smart/manifold4w/supply/hidden/layer4,
/obj/structure/cable,
/turf/open/floor/iron,
/area/station/hallway/primary/central)
"aW" = (
/obj/machinery/atmospherics/pipe/smart/manifold4w/supply/hidden/layer4,
/obj/effect/turf_decal/siding/wood/corner{
	dir = 4
	},
/obj/effect/turf_decal/siding/wood/corner{
	dir = 8
	},
/turf/open/floor/wood/large,
/area/station/command/heads_quarters/nt_rep)
"aX" = (
/obj/effect/spawner/structure/window/reinforced,
/obj/structure/cable,
/obj/machinery/door/poddoor/shutters/preopen{
	id = "nt_rep_priv";
	dir = 1;
	name = "Privacy Shutters"
	},
/turf/open/floor/plating,
/area/station/command/heads_quarters/nt_rep)
"aY" = (
/obj/effect/turf_decal/siding/wood,
/obj/machinery/holopad,
/obj/machinery/atmospherics/pipe/smart/manifold4w/supply/hidden/layer4,
/turf/open/floor/wood/large,
/area/station/command/heads_quarters/nt_rep)
"aZ" = (
/obj/effect/turf_decal/siding/wood{
	dir = 8
	},
/obj/effect/turf_decal/siding/wood/corner,
/obj/machinery/newscaster/directional/west,
/obj/structure/bed/dogbed/ian{
	name = "Lisa's bed";
	desc = "Lisa's bed! Looks comfy."
	},
/mob/living/basic/pet/dog/corgi/lisa,
/turf/open/floor/wood/large,
/area/station/command/heads_quarters/nt_rep)
"sK" = (
/obj/machinery/atmospherics/pipe/smart/manifold4w/scrubbers/hidden/layer2,
/obj/machinery/atmospherics/pipe/smart/manifold4w/supply/hidden/layer4,
/obj/structure/cable,
/turf/open/floor/iron,
/area/station/hallway/primary/central)

(1,1,1) = {"
aB
aB
aB
aB
aK
aB
aB
aB
ai
ai
"}
(2,1,1) = {"
at
aq
aN
ab
al
aZ
av
aB
aB
ai
"}
(3,1,1) = {"
at
ao
ac
aA
ay
aQ
aS
aU
aB
ai
"}
(4,1,1) = {"
at
aP
aL
aO
aG
aY
au
aj
aB
ai
"}
(5,1,1) = {"
at
ah
aR
ak
aI
aa
aE
aJ
aB
ai
"}
(6,1,1) = {"
at
am
am
at
af
aW
aw
ax
aB
aB
"}
(7,1,1) = {"
aV
sK
sK
aX
aX
aC
aD
ae
aT
aB
"}
(8,1,1) = {"
ai
ai
sK
sK
aX
ad
as
an
at
aB
"}
(9,1,1) = {"
ai
ai
ai
sK
aX
aX
ar
aM
at
ai
"}
(10,1,1) = {"
ai
ai
ai
sK
az
aH
ag
at
at
ai
"}
(11,1,1) = {"
ai
ai
ai
ai
aF
at
at
at
ai
ai
"}
