//MAP CONVERTED BY dmm2tgm.py THIS HEADER COMMENT PREVENTS RECONVERSION, DO NOT REMOVE
"a" = (
/turf/closed/wall/r_wall,
/area/station/command/heads_quarters/blueshield)
"b" = (
/turf/template_noop,
/area/template_noop)
"c" = (
/obj/structure/cable,
/obj/machinery/atmospherics/pipe/smart/manifold4w/scrubbers/hidden/layer2,
/obj/machinery/atmospherics/pipe/smart/manifold4w/supply/hidden/layer4,
/obj/machinery/light_switch/directional/east,
/obj/effect/turf_decal/siding/wood/end{
	dir = 4
	},
/turf/open/floor/wood/parquet,
/area/station/command/heads_quarters/blueshield)
"d" = (
/obj/structure/cable,
/obj/machinery/atmospherics/pipe/smart/manifold4w/scrubbers/hidden/layer2,
/obj/machinery/atmospherics/pipe/smart/manifold4w/supply/hidden/layer4,
/turf/open/floor/carpet/blue,
/area/station/command/heads_quarters/blueshield)
"e" = (
/obj/machinery/atmospherics/pipe/smart/manifold4w/scrubbers/hidden/layer2,
/obj/structure/cable,
/obj/machinery/atmospherics/pipe/smart/manifold4w/supply/hidden/layer4,
/obj/machinery/airalarm/directional/east,
/obj/structure/chair/sofa/left/brown{
	dir = 8;
	color = "#3d3c38"
	},
/obj/machinery/light/directional/east,
/turf/open/floor/wood/parquet,
/area/station/command/heads_quarters/blueshield)
"i" = (
/obj/effect/turf_decal/siding/wood{
	dir = 10
	},
/obj/structure/grandfatherclock,
/obj/structure/sign/poster/official/nanotrasen_logo/directional/south,
/turf/open/floor/wood/parquet,
/area/station/command/heads_quarters/blueshield)
"j" = (
/obj/structure/hedge,
/obj/structure/sign/directions/engineering/directional/south{
	pixel_y = -40
	},
/obj/structure/sign/directions/dorms/directional/south{
	pixel_y = -24;
	dir = 8
	},
/obj/structure/sign/directions/evac/directional/south{
	dir = 8
	},
/obj/structure/cable,
/obj/machinery/atmospherics/pipe/smart/manifold4w/supply/hidden/layer4,
/obj/machinery/atmospherics/pipe/smart/manifold4w/scrubbers/hidden/layer2,
/turf/open/floor/iron,
/area/station/hallway/primary/central)
"k" = (
/obj/effect/turf_decal/plaque{
	icon_state = "L4"
	},
/turf/open/floor/iron,
/area/station/hallway/primary/central)
"l" = (
/obj/structure/table/reinforced/titaniumglass,
/obj/item/paper_bin{
	pixel_y = 5;
	pixel_x = -4
	},
/obj/item/pen/fountain/nanotrasen{
	pixel_y = 5;
	pixel_x = -4
	},
/obj/item/stamp{
	pixel_y = 10;
	pixel_x = 8
	},
/obj/item/stamp/denied{
	pixel_x = 8;
	pixel_y = 3
	},
/obj/machinery/camera/directional/south{
	c_tag = "Blueshield's Office"
	},
/obj/machinery/button/door/directional/south{
	name = "Privacy Shutters Control";
	id = "blueshield_priv";
	req_access = list("captain")
	},
/turf/open/floor/carpet/blue,
/area/station/command/heads_quarters/blueshield)
"m" = (
/obj/effect/turf_decal/trimline/blue/filled/corner{
	dir = 8
	},
/obj/structure/cable,
/obj/effect/turf_decal/trimline/dark/corner{
	dir = 8
	},
/obj/machinery/atmospherics/pipe/smart/manifold4w/supply/hidden/layer4,
/obj/machinery/atmospherics/pipe/smart/manifold4w/scrubbers/hidden/layer2,
/obj/machinery/camera/autoname/directional/south,
/obj/machinery/firealarm/directional/south,
/turf/open/floor/iron,
/area/station/hallway/primary/central)
"n" = (
/obj/structure/chair/comfy/black{
	dir = 8
	},
/obj/effect/landmark/start/blueshield,
/turf/open/floor/carpet/blue,
/area/station/command/heads_quarters/blueshield)
"o" = (
/obj/structure/rack,
/obj/effect/spawner/random/clothing/costume,
/turf/open/floor/plating,
/area/station/maintenance/port/aft)
"p" = (
/obj/structure/cable,
/obj/machinery/atmospherics/pipe/smart/manifold4w/scrubbers/hidden/layer2,
/obj/machinery/atmospherics/pipe/smart/manifold4w/supply/hidden/layer4,
/turf/open/floor/wood/parquet,
/area/station/command/heads_quarters/blueshield)
"q" = (
/turf/open/floor/carpet/blue,
/area/station/command/heads_quarters/blueshield)
"r" = (
/obj/machinery/modular_computer/preset/command{
	dir = 4
	},
/obj/machinery/status_display/evac/directional/west,
/obj/machinery/light/directional/west,
/turf/open/floor/carpet/blue,
/area/station/command/heads_quarters/blueshield)
"s" = (
/obj/machinery/atmospherics/pipe/smart/manifold4w/scrubbers/hidden/layer2,
/obj/effect/turf_decal/siding/wood{
	dir = 1
	},
/obj/structure/cable,
/obj/machinery/atmospherics/pipe/smart/manifold4w/supply/hidden/layer4,
/obj/structure/chair/sofa/right/brown{
	dir = 8;
	color = "#3d3c38"
	},
/obj/structure/extinguisher_cabinet/directional/east,
/turf/open/floor/wood/parquet,
/area/station/command/heads_quarters/blueshield)
"t" = (
/obj/effect/turf_decal/tile/blue/diagonal_centre,
/obj/structure/cable,
/obj/machinery/atmospherics/pipe/smart/manifold4w/supply/hidden/layer4,
/turf/open/floor/iron/dark/diagonal,
/area/station/command/heads_quarters/blueshield)
"u" = (
/obj/effect/turf_decal/tile/blue/diagonal_centre,
/obj/machinery/atmospherics/components/unary/vent_pump/on/layer4,
/turf/open/floor/iron/dark/diagonal,
/area/station/command/heads_quarters/blueshield)
"v" = (
/obj/machinery/firealarm/directional/west,
/obj/effect/turf_decal/siding/wood/end{
	dir = 8
	},
/obj/structure/hedge,
/turf/open/floor/wood/parquet,
/area/station/command/heads_quarters/blueshield)
"w" = (
/obj/machinery/door/airlock/highsecurity{
	name = "Blueshield's Armory"
	},
/obj/effect/mapping_helpers/airlock/access/all/command/captain,
/obj/machinery/door/firedoor,
/obj/structure/cable,
/obj/machinery/atmospherics/pipe/smart/manifold4w/scrubbers/hidden/layer2,
/obj/machinery/atmospherics/pipe/smart/manifold4w/supply/hidden/layer4,
/turf/open/floor/iron/dark/smooth_large,
/area/station/command/heads_quarters/blueshield)
"x" = (
/obj/machinery/light/small/dim/directional/east,
/turf/open/floor/plating,
/area/station/maintenance/port/aft)
"z" = (
/obj/machinery/atmospherics/components/unary/vent_pump/on/layer4{
	dir = 4
	},
/turf/open/floor/carpet/blue,
/area/station/command/heads_quarters/blueshield)
"A" = (
/obj/machinery/computer/security{
	dir = 4
	},
/obj/structure/sign/calendar/directional/west,
/obj/item/radio/intercom/directional/south,
/turf/open/floor/carpet/blue,
/area/station/command/heads_quarters/blueshield)
"B" = (
/obj/effect/spawner/structure/window/reinforced,
/obj/machinery/door/poddoor/shutters/preopen{
	id = "blueshield_priv";
	name = "Privacy Shutters";
	dir = 1
	},
/obj/structure/cable,
/turf/open/floor/plating,
/area/station/command/heads_quarters/blueshield)
"C" = (
/obj/machinery/computer/crew{
	dir = 4
	},
/obj/machinery/newscaster/directional/west,
/turf/open/floor/carpet/blue,
/area/station/command/heads_quarters/blueshield)
"D" = (
/obj/effect/turf_decal/siding/thinplating_new/dark{
	dir = 8
	},
/obj/structure/rack/shelf,
/obj/item/storage/toolbox/ammobox/wt550m9,
/obj/machinery/airalarm/directional/east,
/turf/open/floor/iron/dark/small,
/area/station/command/heads_quarters/blueshield)
"E" = (
/turf/open/floor/plating,
/area/station/maintenance/port/aft)
"F" = (
/obj/effect/turf_decal/tile/blue/diagonal_centre,
/obj/structure/cable,
/obj/machinery/atmospherics/pipe/smart/manifold4w/scrubbers/hidden/layer2,
/obj/machinery/atmospherics/pipe/smart/manifold4w/supply/hidden/layer4,
/obj/effect/landmark/start/blueshield,
/turf/open/floor/iron/dark/diagonal,
/area/station/command/heads_quarters/blueshield)
"G" = (
/obj/effect/turf_decal/siding/wood{
	dir = 8
	},
/obj/machinery/holopad,
/obj/effect/landmark/event_spawn,
/turf/open/floor/wood/parquet,
/area/station/command/heads_quarters/blueshield)
"H" = (
/obj/effect/turf_decal/trimline/blue/filled/line,
/obj/structure/cable,
/obj/effect/turf_decal/trimline/dark/line,
/obj/machinery/atmospherics/pipe/smart/manifold4w/supply/hidden/layer4,
/obj/machinery/atmospherics/pipe/smart/manifold4w/scrubbers/hidden/layer2,
/turf/open/floor/iron,
/area/station/hallway/primary/central)
"J" = (
/turf/open/floor/iron,
/area/station/hallway/primary/central)
"K" = (
/obj/effect/turf_decal/siding/thinplating_new/dark{
	dir = 8
	},
/obj/structure/closet/secure_closet/tac{
	req_access = list("captain")
	},
/obj/item/clothing/suit/armor/riot,
/obj/item/clothing/head/helmet/toggleable/riot,
/obj/machinery/status_display/ai/directional/east,
/obj/structure/sign/poster/official/nanotrasen_logo/directional/north,
/obj/machinery/light/red/directional/east,
/turf/open/floor/iron/dark/small,
/area/station/command/heads_quarters/blueshield)
"L" = (
/obj/effect/turf_decal/siding/thinplating_new/dark{
	dir = 8
	},
/obj/structure/closet/secure_closet/blueshield,
/obj/machinery/power/apc/auto_name/directional/east,
/obj/structure/cable,
/turf/open/floor/iron/dark/small,
/area/station/command/heads_quarters/blueshield)
"M" = (
/obj/effect/turf_decal/siding/wood{
	dir = 8
	},
/turf/open/floor/wood/parquet,
/area/station/command/heads_quarters/blueshield)
"N" = (
/obj/effect/turf_decal/siding/wood,
/obj/machinery/atmospherics/components/unary/vent_scrubber/on/layer2{
	dir = 1
	},
/obj/structure/aquarium/prefilled,
/obj/item/reagent_containers/cup/fish_feed{
	pixel_y = 17;
	pixel_x = -3
	},
/turf/open/floor/wood/parquet,
/area/station/command/heads_quarters/blueshield)
"O" = (
/turf/closed/wall/r_wall,
/area/station/command/heads_quarters/nt_rep)
"P" = (
/obj/effect/turf_decal/siding/thinplating_new/dark{
	dir = 8
	},
/obj/structure/rack/shelf,
/obj/item/storage/medkit/brute,
/obj/item/storage/medkit/fire{
	pixel_y = 4
	},
/obj/machinery/status_display/evac/directional/east,
/obj/machinery/light/red/directional/east,
/turf/open/floor/iron/dark/small,
/area/station/command/heads_quarters/blueshield)
"Q" = (
/obj/machinery/atmospherics/pipe/smart/manifold4w/scrubbers/hidden/layer2,
/obj/effect/turf_decal/siding/wood{
	dir = 9
	},
/obj/structure/cable,
/obj/machinery/atmospherics/pipe/smart/manifold4w/supply/hidden/layer4,
/turf/open/floor/wood/parquet,
/area/station/command/heads_quarters/blueshield)
"R" = (
/obj/effect/turf_decal/tile/blue/diagonal_centre,
/obj/structure/sign/poster/official/enlist/directional/south,
/obj/machinery/atmospherics/components/unary/vent_scrubber/on/layer2{
	dir = 1
	},
/obj/machinery/firealarm/directional/west,
/turf/open/floor/iron/dark/diagonal,
/area/station/command/heads_quarters/blueshield)
"S" = (
/obj/effect/landmark/start/hangover,
/turf/open/floor/iron,
/area/station/hallway/primary/central)
"T" = (
/obj/structure/cable,
/obj/machinery/atmospherics/pipe/smart/manifold4w/supply/hidden/layer4,
/obj/machinery/atmospherics/pipe/smart/manifold4w/scrubbers/hidden/layer2,
/turf/open/floor/iron,
/area/station/hallway/primary/central)
"U" = (
/obj/structure/table/reinforced/titaniumglass,
/obj/machinery/recharger{
	pixel_y = 3;
	pixel_x = -6
	},
/obj/item/flashlight/lamp/green{
	pixel_y = 14;
	pixel_x = 5
	},
/obj/item/phone{
	pixel_x = 8;
	pixel_y = -1
	},
/obj/structure/noticeboard/directional/south,
/turf/open/floor/carpet/blue,
/area/station/command/heads_quarters/blueshield)
"X" = (
/obj/effect/turf_decal/plaque{
	icon_state = "L2"
	},
/turf/open/floor/iron,
/area/station/hallway/primary/central)
"Z" = (
/obj/machinery/door/firedoor,
/obj/structure/cable,
/obj/machinery/atmospherics/pipe/smart/manifold4w/scrubbers/hidden/layer2,
/obj/machinery/atmospherics/pipe/smart/manifold4w/supply/hidden/layer4,
/obj/machinery/door/airlock/corporate{
	name = "Blueshield's Office"
	},
/obj/effect/mapping_helpers/airlock/access/all/command/captain,
/obj/effect/landmark/navigate_destination/autoname,
/turf/open/floor/iron/dark/smooth_large,
/area/station/command/heads_quarters/blueshield)

(1,1,1) = {"
b
b
b
b
b
E
b
b
"}
(2,1,1) = {"
b
b
b
b
o
x
b
b
"}
(3,1,1) = {"
b
b
O
O
a
a
a
b
"}
(4,1,1) = {"
O
O
O
C
r
A
a
b
"}
(5,1,1) = {"
H
B
v
z
n
U
a
b
"}
(6,1,1) = {"
H
Z
c
d
q
l
a
a
"}
(7,1,1) = {"
m
a
a
Q
G
M
i
a
"}
(8,1,1) = {"
T
T
B
s
e
p
N
a
"}
(9,1,1) = {"
J
T
a
a
a
w
a
a
"}
(10,1,1) = {"
S
T
a
u
t
F
R
a
"}
(11,1,1) = {"
X
T
a
K
L
D
P
a
"}
(12,1,1) = {"
k
j
a
a
a
a
a
a
"}
