//MAP CONVERTED BY dmm2tgm.py THIS HEADER COMMENT PREVENTS RECONVERSION, DO NOT REMOVE
"a" = (
/turf/closed/wall/r_wall/fakewood,
/area/station/command/gateway)
"f" = (
/obj/effect/spawner/random/structure/closet_maintenance,
/obj/effect/spawner/random/maintenance/two,
/turf/open/floor/plating,
/area/station/biodome/aft)
"k" = (
/obj/effect/spawner/random/structure/grille,
/turf/open/floor/plating,
/area/station/biodome/aft)
"l" = (
/obj/machinery/light/warm/directional/west,
/obj/effect/spawner/random/trash/graffiti,
/turf/open/floor/plating,
/area/station/biodome/aft)
"q" = (
/obj/machinery/door/airlock/maintenance_hatch{
	name = "Maintenance Hatch"
	},
/turf/open/floor/iron/dark/textured,
/area/station/biodome/aft)
"u" = (
/obj/effect/spawner/random/trash/graffiti,
/turf/open/floor/plating,
/area/station/biodome/aft)
"B" = (
/obj/effect/spawner/random/trash/garbage{
	spawn_loot_count = 3;
	spawn_random_offset = 1
	},
/turf/open/floor/plating,
/area/station/biodome/aft)
"E" = (
/obj/effect/spawner/random/structure/girder,
/turf/open/floor/plating,
/area/station/biodome/aft)
"J" = (
/obj/effect/spawner/random/engineering/atmospherics_portable,
/turf/open/floor/plating,
/area/station/biodome/aft)
"P" = (
/obj/effect/spawner/structure/window,
/turf/open/floor/plating,
/area/station/biodome/aft)
"R" = (
/obj/effect/spawner/random/structure/furniture_parts,
/turf/open/floor/plating,
/area/station/biodome/aft)
"S" = (
/turf/open/floor/plating,
/area/station/biodome/aft)
"V" = (
/turf/closed/wall/r_wall/fakewood,
/area/station/command/heads_quarters/captain)
"X" = (
/turf/closed/wall/mineral/wood,
/area/station/biodome/aft)

(1,1,1) = {"
V
J
l
f
a
a
"}
(2,1,1) = {"
V
S
B
S
R
P
"}
(3,1,1) = {"
X
E
S
u
k
P
"}
(4,1,1) = {"
X
X
X
q
X
X
"}
