//MAP CONVERTED BY dmm2tgm.py THIS HEADER COMMENT PREVENTS RECONVERSION, DO NOT REMOVE
"a" = (
/obj/machinery/atmospherics/pipe/smart/manifold4w/supply/hidden/layer4,
/obj/machinery/atmospherics/pipe/smart/manifold4w/scrubbers/hidden/layer2,
/obj/machinery/firealarm/directional/north,
/obj/effect/turf_decal/tile/neutral/anticorner/contrasted{
	dir = 1
	},
/turf/open/floor/iron/dark/corner{
	dir = 1
	},
/area/station/hallway/primary/central)
"b" = (
/obj/effect/turf_decal/siding/wood{
	dir = 5
	},
/obj/machinery/atmospherics/components/unary/vent_scrubber/on/layer2,
/obj/structure/extinguisher_cabinet/directional/north,
/turf/open/floor/wood/parquet,
/area/station/command/heads_quarters/blueshield)
"d" = (
/obj/structure/cable,
/obj/effect/spawner/structure/window/reinforced,
/obj/machinery/door/poddoor/shutters/preopen{
	id = "blueshield_priv";
	name = "Privacy Shutters"
	},
/turf/open/floor/plating,
/area/station/command/heads_quarters/blueshield)
"e" = (
/obj/structure/cable,
/obj/structure/disposalpipe/segment{
	dir = 10
	},
/obj/machinery/atmospherics/pipe/smart/manifold4w/supply/hidden/layer4,
/obj/machinery/atmospherics/pipe/smart/manifold4w/scrubbers/hidden/layer2,
/obj/effect/turf_decal/siding/wood,
/obj/effect/turf_decal/siding/wood{
	dir = 1
	},
/turf/open/floor/wood/parquet,
/area/station/command/heads_quarters/blueshield)
"g" = (
/obj/structure/chair/comfy/black{
	dir = 1
	},
/obj/effect/landmark/start/blueshield,
/turf/open/floor/carpet/blue,
/area/station/command/heads_quarters/blueshield)
"h" = (
/obj/machinery/atmospherics/pipe/smart/manifold4w/supply/hidden/layer4,
/obj/machinery/atmospherics/pipe/smart/manifold4w/scrubbers/hidden/layer2,
/obj/effect/turf_decal/tile/neutral{
	dir = 1
	},
/turf/open/floor/iron/dark/corner{
	dir = 1
	},
/area/station/hallway/primary/central)
"i" = (
/obj/structure/cable,
/obj/structure/disposalpipe/segment{
	dir = 4
	},
/obj/effect/turf_decal/siding/wood,
/obj/effect/turf_decal/siding/wood/corner{
	dir = 4
	},
/obj/machinery/atmospherics/pipe/smart/manifold4w/scrubbers/hidden/layer2,
/obj/machinery/holopad,
/turf/open/floor/wood/parquet,
/area/station/command/heads_quarters/blueshield)
"j" = (
/obj/structure/cable,
/obj/structure/disposalpipe/segment,
/obj/effect/turf_decal/siding/wood/end{
	dir = 1
	},
/obj/structure/sign/poster/official/enlist/directional/west,
/turf/open/floor/wood/parquet,
/area/station/command/heads_quarters/blueshield)
"l" = (
/turf/closed/wall/r_wall/rust,
/area/station/command/heads_quarters/blueshield)
"m" = (
/obj/machinery/atmospherics/pipe/smart/manifold4w/supply/hidden/layer4,
/obj/machinery/atmospherics/pipe/smart/manifold4w/scrubbers/hidden/layer2,
/obj/effect/turf_decal/tile/blue/half/contrasted{
	dir = 1
	},
/obj/effect/turf_decal/tile/neutral{
	dir = 1
	},
/turf/open/floor/iron,
/area/station/hallway/primary/central)
"n" = (
/obj/effect/turf_decal/siding/wood{
	dir = 4
	},
/obj/machinery/atmospherics/pipe/smart/manifold4w/scrubbers/hidden/layer2,
/turf/open/floor/wood/parquet,
/area/station/command/heads_quarters/blueshield)
"o" = (
/turf/closed/wall/r_wall/rust,
/area/station/command/heads_quarters/captain)
"r" = (
/obj/structure/cable,
/obj/structure/disposalpipe/segment,
/obj/effect/turf_decal/siding/wood{
	dir = 8
	},
/obj/effect/turf_decal/siding/wood/corner{
	dir = 4
	},
/turf/open/floor/wood/parquet,
/area/station/command/heads_quarters/blueshield)
"v" = (
/turf/open/floor/carpet/blue,
/area/station/command/heads_quarters/blueshield)
"w" = (
/obj/structure/cable,
/obj/structure/disposalpipe/segment,
/obj/machinery/atmospherics/pipe/smart/manifold4w/supply/hidden/layer4,
/obj/machinery/door/airlock/corporate{
	name = "Blueshield's Office"
	},
/obj/machinery/atmospherics/pipe/smart/manifold4w/scrubbers/hidden/layer2,
/obj/effect/landmark/navigate_destination/autoname,
/obj/effect/mapping_helpers/airlock/access/all/command/captain,
/obj/machinery/door/firedoor,
/turf/open/floor/iron/dark/smooth_large,
/area/station/command/heads_quarters/blueshield)
"x" = (
/obj/machinery/light/directional/north,
/obj/machinery/computer/security,
/obj/structure/sign/clock/directional/north,
/turf/open/floor/carpet/blue,
/area/station/command/heads_quarters/blueshield)
"y" = (
/obj/structure/cable,
/obj/structure/disposalpipe/segment{
	dir = 5
	},
/obj/effect/turf_decal/siding/wood{
	dir = 10
	},
/obj/machinery/firealarm/directional/south,
/obj/structure/closet/secure_closet/tac{
	req_access = list("captain")
	},
/obj/machinery/newscaster/directional/west,
/obj/item/clothing/suit/armor/riot,
/obj/item/clothing/head/helmet/toggleable/riot,
/turf/open/floor/wood/parquet,
/area/station/command/heads_quarters/blueshield)
"A" = (
/turf/closed/wall,
/area/station/hallway/primary/central)
"B" = (
/obj/item/paper_bin{
	pixel_y = 5;
	pixel_x = -4
	},
/obj/item/stamp{
	pixel_y = 10;
	pixel_x = 8
	},
/obj/item/stamp/denied{
	pixel_x = 8;
	pixel_y = 3
	},
/obj/structure/table/wood/fancy/blue,
/obj/machinery/airalarm/directional/east,
/turf/open/floor/carpet/blue,
/area/station/command/heads_quarters/blueshield)
"C" = (
/turf/closed/wall/r_wall,
/area/station/command/heads_quarters/blueshield)
"D" = (
/obj/structure/cable,
/obj/structure/disposalpipe/segment,
/obj/machinery/power/apc/auto_name/directional/west,
/obj/effect/turf_decal/siding/wood{
	dir = 8
	},
/obj/structure/closet/secure_closet/blueshield,
/obj/machinery/camera/autoname/directional/west,
/obj/item/storage/medkit/brute,
/obj/item/storage/medkit/fire,
/turf/open/floor/wood/parquet,
/area/station/command/heads_quarters/blueshield)
"E" = (
/obj/machinery/atmospherics/pipe/smart/manifold4w/supply/hidden/layer4,
/obj/machinery/atmospherics/pipe/smart/manifold4w/scrubbers/hidden/layer2,
/obj/structure/cable,
/obj/structure/disposalpipe/segment,
/turf/open/floor/iron,
/area/station/hallway/primary/central)
"H" = (
/turf/closed/wall/r_wall,
/area/station/command/teleporter)
"K" = (
/obj/structure/cable,
/obj/structure/disposalpipe/segment,
/obj/effect/mapping_helpers/airlock/access/all/command/captain,
/obj/machinery/door/airlock/corporate{
	name = "Blueshield's Office"
	},
/obj/machinery/door/firedoor,
/turf/open/floor/iron/dark/smooth_large,
/area/station/command/heads_quarters/blueshield)
"L" = (
/obj/machinery/atmospherics/pipe/smart/manifold4w/supply/hidden/layer4,
/obj/machinery/atmospherics/pipe/smart/manifold4w/scrubbers/hidden/layer2,
/obj/item/kirbyplants{
	icon_state = "plant-16"
	},
/obj/effect/turf_decal/tile/blue/half/contrasted{
	dir = 1
	},
/obj/effect/turf_decal/tile/neutral{
	dir = 1
	},
/obj/structure/sign/flag/nanotrasen/directional/west,
/turf/open/floor/iron,
/area/station/hallway/primary/central)
"N" = (
/obj/machinery/atmospherics/pipe/smart/manifold4w/supply/hidden/layer4,
/obj/machinery/atmospherics/pipe/smart/manifold4w/scrubbers/hidden/layer2,
/obj/structure/cable,
/obj/machinery/power/apc/auto_name/directional/north,
/obj/effect/turf_decal/tile/blue/half/contrasted{
	dir = 1
	},
/obj/effect/turf_decal/tile/neutral{
	dir = 1
	},
/turf/open/floor/iron,
/area/station/hallway/primary/central)
"T" = (
/obj/machinery/door/airlock/corporate{
	name = "Blueshield's Office"
	},
/obj/effect/mapping_helpers/airlock/access/all/command/captain,
/obj/machinery/door/firedoor,
/obj/structure/cable,
/turf/open/floor/iron/dark/smooth_large,
/area/station/command/heads_quarters/blueshield)
"U" = (
/obj/machinery/computer/crew,
/obj/machinery/button/door/directional/east{
	id = "blueshield_priv";
	req_access = list("captain");
	name = "Privacy Shutters Control"
	},
/obj/structure/sign/calendar/directional/north,
/turf/open/floor/carpet/blue,
/area/station/command/heads_quarters/blueshield)
"V" = (
/obj/machinery/modular_computer/preset/command,
/obj/machinery/status_display/evac/directional/north,
/turf/open/floor/carpet/blue,
/area/station/command/heads_quarters/blueshield)
"W" = (
/turf/template_noop,
/area/template_noop)
"Y" = (
/obj/effect/turf_decal/siding/wood/end{
	dir = 4
	},
/obj/machinery/atmospherics/components/unary/vent_pump/on/layer4{
	dir = 8
	},
/obj/machinery/light_switch/directional/east,
/obj/structure/table/reinforced/titaniumglass,
/obj/machinery/recharger{
	pixel_y = 3;
	pixel_x = -6
	},
/obj/item/flashlight/lamp/green{
	pixel_y = 14;
	pixel_x = 5
	},
/obj/item/phone{
	pixel_x = 8;
	pixel_y = -1
	},
/turf/open/floor/wood/parquet,
/area/station/command/heads_quarters/blueshield)

(1,1,1) = {"
C
C
T
l
C
C
H
"}
(2,1,1) = {"
K
j
r
D
y
C
A
"}
(3,1,1) = {"
C
C
b
n
i
d
L
"}
(4,1,1) = {"
W
l
x
v
e
w
E
"}
(5,1,1) = {"
W
C
V
g
Y
d
m
"}
(6,1,1) = {"
W
C
U
B
l
C
N
"}
(7,1,1) = {"
o
C
C
C
C
a
h
"}
