//MAP CONVERTED BY dmm2tgm.py THIS HEADER COMMENT PREVENTS RECONVERSION, DO NOT REMOVE
"b" = (
/obj/effect/turf_decal/siding/wood{
	dir = 1
	},
/obj/machinery/computer/station_goal,
/turf/open/floor/wood/large,
/area/station/command/heads_quarters/nt_rep)
"c" = (
/obj/structure/chair/sofa/right/brown{
	color = "#462f1c";
	dir = 1
	},
/obj/structure/sign/poster/official/enlist/directional/east,
/turf/open/floor/carpet/royalblue,
/area/station/command/heads_quarters/nt_rep)
"d" = (
/obj/structure/chair/office{
	dir = 8
	},
/obj/effect/landmark/start/nanotrasen_crew_trainer,
/obj/structure/cable,
/turf/open/floor/wood/large,
/area/station/command/heads_quarters/nt_rep)
"e" = (
/turf/closed/wall/r_wall,
/area/station/command/heads_quarters/nt_rep)
"f" = (
/obj/structure/table/reinforced/titaniumglass,
/obj/item/clipboard{
	pixel_y = 3;
	pixel_x = -5
	},
/obj/item/folder/blue{
	pixel_y = 2;
	pixel_x = -4
	},
/obj/item/reagent_containers/cup/glass/mug/nanotrasen{
	pixel_y = 11;
	pixel_x = 11
	},
/obj/item/sign/flag/nanotrasen{
	pixel_x = 5
	},
/turf/open/floor/carpet/executive,
/area/station/command/heads_quarters/nt_rep)
"g" = (
/obj/structure/cable,
/obj/machinery/atmospherics/pipe/smart/manifold4w/scrubbers/hidden/layer2,
/obj/effect/turf_decal/siding/wood{
	dir = 8
	},
/obj/machinery/atmospherics/components/unary/vent_pump/on/layer4{
	dir = 8
	},
/turf/open/floor/wood/large,
/area/station/command/heads_quarters/nt_rep)
"h" = (
/obj/structure/chair/sofa/left/brown{
	color = "#462f1c";
	dir = 1
	},
/turf/open/floor/carpet/royalblue,
/area/station/command/heads_quarters/nt_rep)
"i" = (
/obj/structure/table/wood,
/obj/item/clipboard{
	pixel_y = 3;
	pixel_x = 2
	},
/obj/item/folder/yellow{
	pixel_y = 1;
	pixel_x = -2
	},
/obj/effect/turf_decal/siding/wood{
	dir = 8
	},
/obj/structure/cable,
/turf/open/floor/wood/large,
/area/station/command/heads_quarters/nt_rep)
"j" = (
/turf/template_noop,
/area/template_noop)
"k" = (
/obj/effect/turf_decal/siding/wood{
	dir = 1
	},
/obj/machinery/photocopier/prebuilt,
/obj/item/toy/plush/skyrat/ian/lisa{
	pixel_y = 11
	},
/turf/open/floor/wood/large,
/area/station/command/heads_quarters/nt_rep)
"l" = (
/obj/effect/turf_decal/siding/wood{
	dir = 4
	},
/obj/effect/turf_decal/siding/wood/corner{
	dir = 1
	},
/obj/machinery/atmospherics/pipe/smart/manifold4w/scrubbers/hidden/layer2,
/obj/structure/cable,
/turf/open/floor/wood/large,
/area/station/command/heads_quarters/nt_rep)
"m" = (
/obj/machinery/atmospherics/pipe/smart/manifold4w/scrubbers/hidden/layer2,
/obj/structure/cable,
/obj/effect/turf_decal/siding/wood{
	dir = 8
	},
/turf/open/floor/wood/large,
/area/station/command/heads_quarters/nt_rep)
"o" = (
/obj/effect/turf_decal/siding/wood{
	dir = 1
	},
/obj/effect/turf_decal/siding/wood,
/obj/structure/chair/wood,
/turf/open/floor/wood/large,
/area/station/command/heads_quarters/nt_rep)
"p" = (
/obj/structure/noticeboard/directional/south{
	name = "Nanotrasen Consultant's Notice Board"
	},
/turf/open/floor/carpet/executive,
/area/station/command/heads_quarters/nt_rep)
"q" = (
/obj/effect/turf_decal/siding/wood{
	dir = 4
	},
/obj/effect/landmark/start/nanotrasen_crew_trainer,
/turf/open/floor/wood/large,
/area/station/command/heads_quarters/nt_rep)
"r" = (
/obj/machinery/atmospherics/pipe/smart/manifold4w/scrubbers/hidden/layer2,
/obj/machinery/power/apc/auto_name/directional/west,
/obj/structure/cable,
/obj/effect/turf_decal/siding/wood{
	dir = 8
	},
/obj/effect/turf_decal/siding/wood/corner,
/obj/machinery/holopad,
/turf/open/floor/wood/large,
/area/station/command/heads_quarters/nt_rep)
"t" = (
/obj/effect/turf_decal/siding/wood{
	dir = 4
	},
/obj/machinery/atmospherics/components/unary/vent_scrubber/on/layer2{
	dir = 1
	},
/obj/structure/cable,
/turf/open/floor/wood/large,
/area/station/command/heads_quarters/nt_rep)
"u" = (
/obj/structure/table/wood,
/obj/effect/spawner/random/bureaucracy/folder{
	spawn_random_offset = 1
	},
/turf/open/floor/carpet/royalblue,
/area/station/command/heads_quarters/nt_rep)
"v" = (
/obj/effect/turf_decal/siding/wood{
	dir = 4
	},
/turf/open/floor/wood/large,
/area/station/command/heads_quarters/nt_rep)
"w" = (
/obj/structure/sign/flag/nanotrasen,
/turf/closed/wall/r_wall,
/area/station/command/heads_quarters/nt_rep)
"x" = (
/obj/machinery/airalarm/directional/east,
/obj/effect/turf_decal/siding/wood/end{
	dir = 4
	},
/obj/structure/bed/dogbed/ian{
	name = "Lisa's bed";
	desc = "Lisa's bed! Looks comfy."
	},
/mob/living/basic/pet/dog/corgi/lisa,
/turf/open/floor/wood/large,
/area/station/command/heads_quarters/nt_rep)
"y" = (
/obj/effect/turf_decal/siding/wood,
/obj/effect/turf_decal/siding/wood/corner{
	dir = 4
	},
/turf/open/floor/wood/large,
/area/station/command/heads_quarters/nt_rep)
"z" = (
/obj/structure/chair/sofa/left/brown{
	color = "#462f1c"
	},
/obj/structure/sign/poster/official/nanotrasen_logo/directional/north,
/turf/open/floor/carpet/royalblue,
/area/station/command/heads_quarters/nt_rep)
"D" = (
/obj/effect/turf_decal/siding/wood{
	dir = 5
	},
/obj/machinery/firealarm/directional/north,
/turf/open/floor/wood/large,
/area/station/command/heads_quarters/nt_rep)
"E" = (
/obj/machinery/modular_computer/preset/command{
	dir = 8
	},
/obj/machinery/requests_console/directional/east{
	name = "Nanotrasen Consultant's Requests Console";
	department = "Nanotrasen Consultant's Desk"
	},
/obj/effect/mapping_helpers/requests_console/announcement,
/obj/effect/mapping_helpers/requests_console/assistance,
/obj/effect/mapping_helpers/requests_console/information,
/turf/open/floor/carpet/executive,
/area/station/command/heads_quarters/nt_rep)
"F" = (
/obj/machinery/light/directional/south,
/obj/machinery/status_display/evac/directional/south,
/obj/structure/safe/floor,
/obj/item/clothing/accessory/medal/gold/nanotrasen_consultant,
/obj/item/clothing/accessory/medal/silver/bureaucracy,
/obj/item/clothing/accessory/medal/gold/ordom,
/turf/open/floor/carpet/executive,
/area/station/command/heads_quarters/nt_rep)
"G" = (
/obj/structure/sign/calendar/directional/south,
/obj/machinery/keycard_auth/wall_mounted/directional/east,
/obj/structure/closet/secure_closet/nanotrasen_consultant,
/turf/open/floor/carpet/executive,
/area/station/command/heads_quarters/nt_rep)
"H" = (
/obj/machinery/light_switch/directional/north,
/obj/effect/turf_decal/siding/wood{
	dir = 9
	},
/obj/structure/filingcabinet/employment{
	name = "employment forms filing cabinet"
	},
/obj/structure/filingcabinet/medical{
	pixel_x = -10;
	icon_state = "employmentcabinet";
	name = "medical records filing cabinet"
	},
/obj/structure/filingcabinet/security{
	pixel_x = 10;
	icon_state = "employmentcabinet";
	name = "security records filing cabinet"
	},
/turf/open/floor/wood/large,
/area/station/command/heads_quarters/nt_rep)
"I" = (
/obj/machinery/door/poddoor/shutters/preopen{
	id = "nt_rep_priv";
	dir = 8;
	name = "Privacy Shutters"
	},
/obj/effect/spawner/structure/window/reinforced,
/obj/structure/cable,
/turf/open/floor/plating,
/area/station/command/heads_quarters/nt_rep)
"J" = (
/obj/structure/table/reinforced/titaniumglass,
/obj/machinery/camera/autoname/directional/east,
/obj/item/flashlight/lamp/green{
	pixel_y = 13;
	pixel_x = -6
	},
/obj/item/phone{
	pixel_x = -4;
	pixel_y = -1
	},
/obj/machinery/recharger{
	pixel_y = 3;
	pixel_x = 7
	},
/obj/structure/sign/clock/directional/east,
/turf/open/floor/carpet/executive,
/area/station/command/heads_quarters/nt_rep)
"K" = (
/obj/structure/table/wood,
/obj/effect/turf_decal/siding/wood{
	dir = 10
	},
/obj/item/table_clock,
/turf/open/floor/wood/large,
/area/station/command/heads_quarters/nt_rep)
"L" = (
/obj/machinery/door/airlock/maintenance,
/obj/effect/mapping_helpers/airlock/access/all/cent_com/rep_door,
/turf/open/floor/iron/dark/textured_large,
/area/station/command/heads_quarters/nt_rep)
"M" = (
/obj/effect/turf_decal/siding/wood,
/turf/open/floor/wood/large,
/area/station/command/heads_quarters/nt_rep)
"N" = (
/obj/structure/chair/sofa/right/brown{
	color = "#462f1c"
	},
/obj/item/radio/intercom/directional/north,
/turf/open/floor/carpet/royalblue,
/area/station/command/heads_quarters/nt_rep)
"O" = (
/obj/effect/turf_decal/siding/wood{
	dir = 6
	},
/obj/machinery/newscaster/directional/south,
/turf/open/floor/wood/large,
/area/station/command/heads_quarters/nt_rep)
"P" = (
/obj/machinery/light/directional/east,
/obj/structure/table/wood,
/obj/item/taperecorder{
	pixel_y = 2;
	pixel_x = -5
	},
/obj/item/tape{
	pixel_x = 4
	},
/obj/machinery/vending/boozeomat{
	density = 0;
	req_access = list("cent_general");
	pixel_x = 32
	},
/turf/open/floor/carpet/royalblue,
/area/station/command/heads_quarters/nt_rep)
"Q" = (
/obj/machinery/light/directional/south,
/obj/structure/closet/secure_closet/nanotrasen_crew_trainer,
/obj/effect/turf_decal/siding/wood,
/obj/item/storage/lunchbox/nanotrasen,
/obj/structure/extinguisher_cabinet/directional/south,
/turf/open/floor/wood/large,
/area/station/command/heads_quarters/nt_rep)
"R" = (
/obj/item/paper_bin{
	pixel_y = 5;
	pixel_x = -4
	},
/obj/item/stamp{
	pixel_y = 12;
	pixel_x = 8
	},
/obj/item/stamp/denied{
	pixel_x = 8;
	pixel_y = 6
	},
/obj/structure/table/reinforced/titaniumglass,
/obj/item/stamp/nanotrasen{
	pixel_x = 8
	},
/obj/item/pen/fountain/nanotrasen{
	pixel_y = 5;
	pixel_x = -4
	},
/turf/open/floor/carpet/executive,
/area/station/command/heads_quarters/nt_rep)
"T" = (
/obj/structure/table/reinforced/titaniumglass,
/obj/machinery/fax{
	fax_name = "Nanotrasen Consultant's Office";
	name = "Nanotrasen Consultant's Fax Machine"
	},
/turf/open/floor/carpet/executive,
/area/station/command/heads_quarters/nt_rep)
"U" = (
/obj/structure/chair/comfy/brown{
	dir = 1
	},
/obj/effect/landmark/start/nanotrasen_consultant,
/turf/open/floor/carpet/executive,
/area/station/command/heads_quarters/nt_rep)
"V" = (
/obj/structure/cable,
/turf/open/floor/wood/large,
/area/station/command/heads_quarters/nt_rep)
"W" = (
/obj/structure/table/wood,
/obj/effect/turf_decal/siding/wood{
	dir = 9
	},
/obj/item/paper_bin{
	pixel_y = 5;
	pixel_x = -4
	},
/obj/item/pen{
	pixel_y = 5;
	pixel_x = -4
	},
/obj/item/stamp{
	pixel_y = 9;
	pixel_x = 8
	},
/obj/item/stamp/denied{
	pixel_x = 8;
	pixel_y = 2
	},
/turf/open/floor/wood/large,
/area/station/command/heads_quarters/nt_rep)
"X" = (
/obj/effect/mapping_helpers/airlock/access/all/cent_com/rep_door,
/obj/machinery/door/firedoor,
/obj/machinery/atmospherics/pipe/smart/manifold4w/scrubbers/hidden/layer2,
/obj/structure/cable,
/obj/machinery/atmospherics/pipe/smart/manifold4w/supply/hidden/layer4,
/obj/effect/mapping_helpers/airlock/unres{
	dir = 4
	},
/obj/effect/landmark/navigate_destination/autoname,
/obj/machinery/door/airlock/corporate{
	name = "Nanotrasen Internal Affairs Office"
	},
/turf/open/floor/iron/dark/textured_large,
/area/station/command/heads_quarters/nt_rep)
"Y" = (
/obj/effect/spawner/structure/window/reinforced,
/obj/machinery/door/poddoor/shutters/preopen{
	id = "nt_rep_priv";
	dir = 8;
	name = "Privacy Shutters"
	},
/obj/structure/cable,
/turf/open/floor/plating,
/area/station/command/heads_quarters/nt_rep)

(1,1,1) = {"
j
j
j
j
e
I
I
I
e
"}
(2,1,1) = {"
j
j
j
j
w
W
i
K
w
"}
(3,1,1) = {"
j
j
j
j
e
b
d
Q
e
"}
(4,1,1) = {"
e
Y
X
Y
e
k
V
M
L
"}
(5,1,1) = {"
e
H
g
m
r
l
t
O
e
"}
(6,1,1) = {"
e
D
v
q
y
T
R
p
e
"}
(7,1,1) = {"
e
N
u
h
o
f
U
F
e
"}
(8,1,1) = {"
e
z
P
c
x
J
E
G
e
"}
(9,1,1) = {"
e
e
e
e
e
e
e
e
e
"}
