//MAP CONVERTED BY dmm2tgm.py THIS HEADER COMMENT PREVENTS RECONVERSION, DO NOT REMOVE
"a" = (
/obj/machinery/firealarm/directional/south,
/obj/structure/disposalpipe/segment{
	dir = 4
	},
/obj/effect/turf_decal/tile/neutral,
/turf/open/floor/iron,
/area/station/hallway/primary/central)
"b" = (
/obj/machinery/door/firedoor,
/obj/structure/disposalpipe/segment{
	dir = 4
	},
/obj/effect/turf_decal/tile/neutral,
/obj/machinery/atmospherics/pipe/smart/manifold4w/supply/hidden/layer4,
/obj/machinery/airalarm/directional/south,
/turf/open/floor/iron,
/area/station/hallway/primary/central)
"c" = (
/obj/machinery/firealarm/directional/south,
/obj/machinery/camera/autoname/directional/south,
/obj/structure/table/wood/fancy/blue,
/obj/item/storage/medkit/brute{
	pixel_y = 4
	},
/obj/item/storage/medkit/fire{
	pixel_y = 9
	},
/turf/open/floor/carpet/blue,
/area/station/command/heads_quarters/blueshield)
"d" = (
/obj/machinery/door/airlock/highsecurity{
	name = "Blueshield's Armory"
	},
/obj/machinery/door/firedoor,
/obj/machinery/atmospherics/pipe/smart/manifold4w/supply/hidden/layer4,
/obj/machinery/atmospherics/pipe/smart/manifold4w/scrubbers/hidden/layer2,
/obj/structure/cable,
/obj/effect/mapping_helpers/airlock/access/all/command/captain,
/turf/open/floor/iron/dark/textured_large,
/area/station/command/heads_quarters/blueshield)
"e" = (
/obj/effect/turf_decal/tile/blue/diagonal_centre,
/obj/structure/sign/poster/official/nanotrasen_logo/directional/east,
/obj/machinery/power/apc/auto_name/directional/north,
/obj/structure/cable,
/turf/open/floor/iron/dark/diagonal,
/area/station/command/heads_quarters/blueshield)
"f" = (
/obj/effect/decal/cleanable/dirt,
/obj/structure/table/reinforced,
/obj/machinery/door/firedoor,
/obj/machinery/door/poddoor/shutters{
	dir = 8;
	id = "commissaryshutter";
	name = "Vacant Commissary Shutter"
	},
/obj/effect/turf_decal/stripes/line{
	dir = 8
	},
/obj/effect/turf_decal/stripes/line{
	dir = 4
	},
/obj/machinery/atmospherics/pipe/smart/manifold4w/scrubbers/hidden/layer2,
/turf/open/floor/iron,
/area/station/commons/vacant_room/commissary)
"g" = (
/obj/structure/cable,
/obj/machinery/atmospherics/pipe/smart/manifold4w/supply/hidden/layer4,
/obj/machinery/door/airlock/corporate{
	name = "Blueshield's Office"
	},
/obj/machinery/door/firedoor,
/obj/effect/mapping_helpers/airlock/access/all/command/captain,
/obj/effect/landmark/navigate_destination/autoname,
/turf/open/floor/iron/dark/textured_large,
/area/station/command/heads_quarters/blueshield)
"h" = (
/obj/machinery/atmospherics/pipe/smart/manifold4w/supply/hidden/layer4,
/obj/machinery/atmospherics/pipe/smart/manifold4w/scrubbers/hidden/layer2,
/obj/structure/cable,
/obj/effect/turf_decal/siding/wood{
	dir = 10
	},
/turf/open/floor/wood/parquet,
/area/station/command/heads_quarters/blueshield)
"i" = (
/obj/effect/turf_decal/tile/blue/diagonal_centre,
/obj/machinery/atmospherics/components/unary/vent_pump/on/layer4{
	dir = 1
	},
/obj/machinery/atmospherics/pipe/smart/manifold4w/scrubbers/hidden/layer2,
/obj/structure/cable,
/obj/effect/landmark/start/blueshield,
/turf/open/floor/iron/dark/diagonal,
/area/station/command/heads_quarters/blueshield)
"j" = (
/obj/effect/decal/cleanable/dirt,
/obj/structure/cable,
/obj/machinery/atmospherics/pipe/smart/manifold4w/supply/hidden/layer4,
/obj/effect/turf_decal/tile/brown{
	dir = 4
	},
/obj/effect/turf_decal/tile/neutral,
/obj/machinery/firealarm/directional/east,
/turf/open/floor/iron,
/area/station/commons/vacant_room/commissary)
"k" = (
/obj/structure/chair/comfy/black{
	dir = 8
	},
/obj/effect/landmark/start/blueshield,
/turf/open/floor/carpet/blue,
/area/station/command/heads_quarters/blueshield)
"l" = (
/obj/structure/disposalpipe/segment{
	dir = 4
	},
/obj/effect/turf_decal/tile/neutral,
/obj/structure/extinguisher_cabinet/directional/south,
/turf/open/floor/iron,
/area/station/hallway/primary/central)
"m" = (
/obj/effect/turf_decal/tile/blue/diagonal_centre,
/obj/structure/sign/poster/official/enlist/directional/west,
/obj/machinery/firealarm/directional/north,
/turf/open/floor/iron/dark/diagonal,
/area/station/command/heads_quarters/blueshield)
"n" = (
/obj/effect/spawner/structure/window/reinforced,
/turf/open/floor/plating,
/area/station/hallway/primary/central)
"o" = (
/obj/machinery/computer/security{
	dir = 4
	},
/obj/structure/extinguisher_cabinet/directional/south,
/obj/machinery/newscaster/directional/west,
/turf/open/floor/carpet/blue,
/area/station/command/heads_quarters/blueshield)
"p" = (
/turf/closed/wall,
/area/station/commons/vacant_room/commissary)
"q" = (
/obj/structure/table/reinforced/titaniumglass,
/obj/machinery/recharger{
	pixel_y = 3;
	pixel_x = -6
	},
/obj/item/flashlight/lamp/green{
	pixel_y = 14;
	pixel_x = 5
	},
/obj/item/phone{
	pixel_x = 8;
	pixel_y = -1
	},
/obj/machinery/atmospherics/components/unary/vent_scrubber/on/layer2{
	dir = 8
	},
/obj/machinery/button/door/directional/east{
	id = "blueshield_priv";
	req_access = list("captain");
	name = "Privacy Shutters Control";
	pixel_y = -6
	},
/obj/effect/turf_decal/siding/wood{
	dir = 5
	},
/obj/machinery/light_switch/directional/east{
	pixel_y = 6;
	pixel_x = 24
	},
/turf/open/floor/wood/parquet,
/area/station/command/heads_quarters/blueshield)
"s" = (
/obj/structure/disposalpipe/segment{
	dir = 4
	},
/obj/effect/turf_decal/tile/neutral,
/obj/machinery/atmospherics/pipe/smart/manifold4w/supply/hidden/layer4,
/turf/open/floor/iron,
/area/station/hallway/primary/central)
"t" = (
/obj/machinery/camera/directional/east{
	c_tag = "Vacant Commissary"
	},
/obj/structure/cable,
/obj/machinery/power/apc/auto_name/directional/east,
/obj/effect/turf_decal/tile/brown/opposingcorners{
	dir = 1
	},
/obj/effect/turf_decal/tile/neutral,
/obj/structure/table,
/obj/item/paper_bin{
	pixel_x = -2;
	pixel_y = 4
	},
/obj/item/pen,
/obj/structure/secure_safe/directional/south,
/turf/open/floor/iron,
/area/station/commons/vacant_room/commissary)
"u" = (
/obj/machinery/door/airlock{
	id_tag = "commissarydoor";
	name = "Commissary"
	},
/obj/effect/mapping_helpers/airlock/access/all/engineering/maintenance,
/obj/effect/mapping_helpers/airlock/unres,
/obj/machinery/atmospherics/pipe/smart/manifold4w/supply/hidden/layer4,
/obj/structure/cable,
/turf/open/floor/plating,
/area/station/commons/vacant_room/commissary)
"v" = (
/obj/structure/disposalpipe/segment{
	dir = 4
	},
/obj/effect/turf_decal/tile/neutral,
/obj/machinery/atmospherics/pipe/smart/manifold4w/supply/hidden/layer4,
/obj/structure/cable,
/turf/open/floor/iron,
/area/station/hallway/primary/central)
"w" = (
/obj/effect/decal/cleanable/dirt,
/obj/machinery/light/small/directional/east,
/obj/structure/cable,
/obj/machinery/button/door/directional/east{
	id = "commissarydoor";
	name = "Commissary Door Lock";
	normaldoorcontrol = 1;
	specialfunctions = 4
	},
/obj/effect/turf_decal/tile/brown{
	dir = 4
	},
/obj/effect/turf_decal/tile/neutral,
/obj/structure/rack,
/obj/item/wrench,
/obj/item/screwdriver,
/obj/machinery/atmospherics/components/unary/vent_scrubber/on/layer2{
	dir = 8
	},
/turf/open/floor/iron,
/area/station/commons/vacant_room/commissary)
"x" = (
/obj/effect/decal/cleanable/dirt,
/obj/structure/table/reinforced,
/obj/machinery/door/firedoor,
/obj/machinery/door/poddoor/shutters{
	dir = 8;
	id = "commissaryshutter";
	name = "Vacant Commissary Shutter"
	},
/obj/structure/noticeboard/directional/north,
/obj/effect/turf_decal/stripes/line{
	dir = 8
	},
/obj/effect/turf_decal/stripes/line{
	dir = 4
	},
/turf/open/floor/iron,
/area/station/commons/vacant_room/commissary)
"y" = (
/obj/machinery/airalarm/directional/north,
/obj/structure/closet/secure_closet/personal,
/obj/effect/spawner/random/bureaucracy/briefcase,
/obj/effect/turf_decal/tile/brown/opposingcorners{
	dir = 1
	},
/obj/effect/turf_decal/tile/neutral{
	dir = 1
	},
/obj/item/stack/package_wrap,
/obj/item/hand_labeler,
/turf/open/floor/iron,
/area/station/commons/vacant_room/commissary)
"z" = (
/obj/effect/turf_decal/siding/thinplating_new/dark{
	dir = 1
	},
/obj/structure/closet/secure_closet/tac{
	req_access = list("captain")
	},
/obj/machinery/status_display/ai/directional/south,
/obj/machinery/light/red/directional/south,
/obj/machinery/atmospherics/pipe/smart/manifold4w/scrubbers/hidden/layer2,
/obj/item/clothing/suit/armor/riot,
/obj/item/clothing/head/helmet/toggleable/riot,
/turf/open/floor/iron/dark/small,
/area/station/command/heads_quarters/blueshield)
"A" = (
/obj/structure/cable,
/obj/machinery/atmospherics/pipe/smart/manifold4w/supply/hidden/layer4,
/obj/machinery/atmospherics/pipe/smart/manifold4w/scrubbers/hidden/layer2,
/obj/machinery/holopad,
/obj/effect/turf_decal/siding/wood{
	dir = 8
	},
/turf/open/floor/wood/parquet,
/area/station/command/heads_quarters/blueshield)
"B" = (
/obj/structure/disposalpipe/segment{
	dir = 4
	},
/obj/effect/turf_decal/tile/neutral,
/obj/machinery/atmospherics/pipe/smart/manifold4w/supply/hidden/layer4,
/obj/structure/sign/flag/nanotrasen/directional/south,
/turf/open/floor/iron,
/area/station/hallway/primary/central)
"C" = (
/turf/closed/wall/r_wall,
/area/station/command/heads_quarters/blueshield)
"D" = (
/obj/machinery/atmospherics/components/unary/vent_pump/on/layer4{
	dir = 4
	},
/turf/open/floor/plating,
/area/station/commons/vacant_room/commissary)
"E" = (
/turf/template_noop,
/area/template_noop)
"F" = (
/obj/structure/disposalpipe/segment{
	dir = 4
	},
/obj/effect/turf_decal/tile/neutral,
/turf/open/floor/iron,
/area/station/hallway/primary/central)
"G" = (
/turf/closed/wall/r_wall,
/area/station/command/heads_quarters/hop)
"H" = (
/obj/structure/disposalpipe/segment{
	dir = 4
	},
/obj/effect/turf_decal/tile/neutral,
/obj/machinery/light/directional/south,
/turf/open/floor/iron,
/area/station/hallway/primary/central)
"I" = (
/obj/machinery/computer/crew{
	dir = 4
	},
/obj/structure/sign/calendar/directional/west,
/turf/open/floor/carpet/blue,
/area/station/command/heads_quarters/blueshield)
"J" = (
/obj/structure/disposalpipe/segment{
	dir = 4
	},
/obj/effect/turf_decal/tile/neutral,
/mob/living/basic/bot/cleanbot/autopatrol,
/obj/machinery/atmospherics/pipe/smart/manifold4w/supply/hidden/layer4,
/obj/structure/cable,
/turf/open/floor/iron,
/area/station/hallway/primary/central)
"K" = (
/obj/effect/decal/cleanable/dirt,
/obj/structure/chair/stool/directional/west,
/obj/machinery/atmospherics/pipe/smart/manifold4w/scrubbers/hidden/layer2,
/obj/effect/turf_decal/tile/brown{
	dir = 8
	},
/obj/effect/turf_decal/tile/neutral{
	dir = 1
	},
/turf/open/floor/iron,
/area/station/commons/vacant_room/commissary)
"L" = (
/obj/structure/table/reinforced/titaniumglass,
/obj/item/paper_bin{
	pixel_y = 5;
	pixel_x = -4
	},
/obj/item/pen/fountain/nanotrasen{
	pixel_y = 5;
	pixel_x = -4
	},
/obj/item/stamp{
	pixel_y = 10;
	pixel_x = 8
	},
/obj/item/stamp/denied{
	pixel_x = 8;
	pixel_y = 3
	},
/obj/machinery/atmospherics/components/unary/vent_pump/on/layer4{
	dir = 8
	},
/obj/structure/sign/clock/directional/east,
/obj/structure/secure_safe/directional/south,
/obj/effect/turf_decal/siding/wood{
	dir = 6
	},
/turf/open/floor/wood/parquet,
/area/station/command/heads_quarters/blueshield)
"M" = (
/obj/machinery/airalarm/directional/west,
/obj/machinery/modular_computer/preset/command{
	dir = 4
	},
/obj/machinery/light/directional/west,
/turf/open/floor/carpet/blue,
/area/station/command/heads_quarters/blueshield)
"N" = (
/obj/effect/decal/cleanable/dirt,
/obj/structure/table,
/obj/machinery/button/door/directional/west{
	id = "commissaryshutter";
	name = "Commissary Shutter Control"
	},
/obj/effect/turf_decal/tile/brown{
	dir = 8
	},
/obj/effect/turf_decal/tile/neutral/opposingcorners,
/obj/machinery/newscaster/directional/south,
/obj/item/stack/sheet/iron/five,
/obj/item/stack/cable_coil/five,
/turf/open/floor/iron,
/area/station/commons/vacant_room/commissary)
"O" = (
/obj/effect/turf_decal/siding/thinplating_new/dark{
	dir = 1
	},
/obj/structure/closet/secure_closet/blueshield,
/turf/open/floor/iron/dark/small,
/area/station/command/heads_quarters/blueshield)
"P" = (
/obj/effect/turf_decal/tile/blue/diagonal_centre,
/obj/machinery/airalarm/directional/north,
/obj/machinery/atmospherics/components/unary/vent_scrubber/on/layer2,
/obj/machinery/camera/autoname/directional/north,
/obj/structure/cable,
/turf/open/floor/iron/dark/diagonal,
/area/station/command/heads_quarters/blueshield)
"Q" = (
/obj/effect/spawner/structure/window/reinforced,
/obj/structure/cable,
/obj/machinery/door/poddoor/shutters/preopen{
	id = "blueshield_priv";
	name = "Privacy Shutters";
	dir = 4
	},
/turf/open/floor/plating,
/area/station/command/heads_quarters/blueshield)
"R" = (
/obj/effect/turf_decal/siding/thinplating_new/dark{
	dir = 5
	},
/obj/structure/rack/shelf,
/obj/item/storage/toolbox/ammobox/wt550m9,
/obj/machinery/atmospherics/pipe/smart/manifold4w/scrubbers/hidden/layer2,
/turf/open/floor/iron/dark/small,
/area/station/command/heads_quarters/blueshield)
"S" = (
/obj/effect/spawner/structure/window/reinforced,
/obj/structure/cable,
/obj/machinery/door/poddoor/shutters/preopen{
	id = "blueshield_priv";
	name = "Privacy Shutters";
	dir = 1
	},
/turf/open/floor/plating,
/area/station/command/heads_quarters/blueshield)
"T" = (
/turf/open/floor/carpet/blue,
/area/station/command/heads_quarters/blueshield)
"U" = (
/obj/machinery/light_switch/directional/east,
/obj/item/radio/intercom/directional/east{
	pixel_y = 8
	},
/obj/effect/turf_decal/tile/brown{
	dir = 4
	},
/obj/effect/turf_decal/tile/neutral/opposingcorners,
/obj/machinery/atmospherics/pipe/smart/manifold4w/supply/hidden/layer4,
/obj/structure/cable,
/turf/open/floor/iron,
/area/station/commons/vacant_room/commissary)
"V" = (
/obj/effect/turf_decal/tile/blue/diagonal_centre,
/obj/machinery/atmospherics/pipe/smart/manifold4w/scrubbers/hidden/layer2,
/turf/open/floor/iron/dark/diagonal,
/area/station/command/heads_quarters/blueshield)
"W" = (
/obj/structure/cable,
/obj/structure/table/reinforced/titaniumglass,
/obj/item/clipboard{
	pixel_y = 4;
	pixel_x = -3
	},
/obj/item/folder/red{
	pixel_y = 3;
	pixel_x = -1
	},
/obj/item/folder/blue{
	pixel_y = 4;
	pixel_x = 3
	},
/obj/item/sign/flag/nanotrasen,
/obj/effect/turf_decal/siding/wood{
	dir = 4
	},
/turf/open/floor/wood/parquet,
/area/station/command/heads_quarters/blueshield)
"X" = (
/obj/machinery/door/airlock/highsecurity{
	name = "Blueshield's Armory"
	},
/obj/machinery/door/firedoor,
/obj/machinery/atmospherics/pipe/smart/manifold4w/scrubbers/hidden/layer2,
/obj/effect/mapping_helpers/airlock/access/all/command/captain,
/turf/open/floor/iron/dark/textured_large,
/area/station/command/heads_quarters/blueshield)
"Y" = (
/obj/structure/cable,
/obj/effect/spawner/structure/window/reinforced,
/obj/machinery/door/poddoor/shutters/preopen{
	id = "blueshield_priv";
	name = "Privacy Shutters";
	dir = 1
	},
/turf/open/floor/plating,
/area/station/command/heads_quarters/blueshield)
"Z" = (
/obj/machinery/atmospherics/pipe/smart/manifold4w/supply/hidden/layer4,
/obj/structure/cable,
/obj/machinery/atmospherics/pipe/smart/manifold4w/scrubbers/hidden/layer2,
/obj/effect/turf_decal/siding/wood{
	dir = 9
	},
/turf/open/floor/wood/parquet,
/area/station/command/heads_quarters/blueshield)

(1,1,1) = {"
E
E
E
E
E
E
E
E
E
"}
(2,1,1) = {"
l
p
p
x
f
p
G
E
E
"}
(3,1,1) = {"
H
p
y
D
K
N
G
E
E
"}
(4,1,1) = {"
J
u
U
j
w
t
G
E
E
"}
(5,1,1) = {"
b
C
C
C
C
C
G
E
E
"}
(6,1,1) = {"
B
C
I
M
o
C
C
C
C
"}
(7,1,1) = {"
s
S
T
k
c
C
m
O
C
"}
(8,1,1) = {"
v
g
Z
A
h
d
i
z
C
"}
(9,1,1) = {"
F
Y
q
W
L
C
P
R
C
"}
(10,1,1) = {"
a
C
C
Q
C
C
e
V
C
"}
(11,1,1) = {"
F
n
E
E
E
C
C
X
C
"}
