//MAP CONVERTED BY dmm2tgm.py THIS HEADER COMMENT PREVENTS RECONVERSION, DO NOT REMOVE
"a" = (
/turf/closed/wall/r_wall,
/area/station/command/heads_quarters/blueshield)
"c" = (
/obj/machinery/light/red/directional/north,
/obj/effect/turf_decal/tile/blue/diagonal_centre,
/obj/machinery/atmospherics/components/unary/vent_scrubber/on/layer2{
	dir = 8
	},
/turf/open/floor/iron/dark/diagonal,
/area/station/command/heads_quarters/blueshield)
"d" = (
/obj/structure/cable,
/obj/effect/turf_decal/tile/blue/diagonal_centre,
/obj/structure/sign/poster/official/nanotrasen_logo/directional/west,
/obj/machinery/atmospherics/pipe/smart/manifold4w/scrubbers/hidden/layer2,
/obj/machinery/atmospherics/pipe/smart/manifold4w/supply/hidden/layer4,
/turf/open/floor/iron/dark/diagonal,
/area/station/command/heads_quarters/blueshield)
"f" = (
/obj/structure/table,
/obj/item/paper_bin,
/obj/item/pen,
/obj/machinery/firealarm/directional/east,
/obj/effect/turf_decal/tile/neutral/fourcorners,
/turf/open/floor/iron/dark,
/area/station/hallway/secondary/exit)
"h" = (
/obj/structure/cable,
/obj/effect/turf_decal/tile/blue/diagonal_centre,
/obj/machinery/atmospherics/pipe/smart/manifold4w/scrubbers/hidden/layer2,
/obj/machinery/atmospherics/components/unary/vent_pump/on/layer4{
	dir = 8
	},
/obj/effect/landmark/start/blueshield,
/turf/open/floor/iron/dark/diagonal,
/area/station/command/heads_quarters/blueshield)
"i" = (
/obj/structure/table/wood/fancy/blue,
/obj/item/paper_bin{
	pixel_y = 5;
	pixel_x = -4
	},
/obj/item/stamp{
	pixel_y = 10;
	pixel_x = 8
	},
/obj/item/stamp/denied{
	pixel_x = 8;
	pixel_y = 3
	},
/obj/item/pen/fountain/nanotrasen{
	pixel_y = 5;
	pixel_x = -4
	},
/obj/machinery/newscaster/directional/north,
/obj/effect/turf_decal/siding/wood{
	dir = 1
	},
/obj/machinery/atmospherics/components/unary/vent_pump/on/layer4,
/turf/open/floor/wood/parquet,
/area/station/command/heads_quarters/blueshield)
"j" = (
/obj/effect/turf_decal/siding/thinplating_new/dark{
	dir = 1
	},
/obj/structure/rack/shelf,
/obj/item/storage/medkit/brute,
/obj/item/storage/medkit/fire{
	pixel_y = 4
	},
/obj/machinery/status_display/ai/directional/south,
/turf/open/floor/iron/dark/small,
/area/station/command/heads_quarters/blueshield)
"k" = (
/obj/structure/grandfatherclock,
/obj/structure/extinguisher_cabinet/directional/north,
/obj/effect/turf_decal/siding/wood{
	dir = 1
	},
/obj/machinery/atmospherics/components/unary/vent_scrubber/on/layer2,
/turf/open/floor/wood/parquet,
/area/station/command/heads_quarters/blueshield)
"n" = (
/obj/machinery/computer/security{
	dir = 1
	},
/obj/machinery/button/door/directional/east{
	id = "blueshield_priv";
	req_access = list("captain");
	name = "Privacy Shutters Control"
	},
/obj/item/radio/intercom/directional/south,
/turf/open/floor/carpet/blue,
/area/station/command/heads_quarters/blueshield)
"o" = (
/obj/effect/turf_decal/tile/blue/diagonal_centre,
/obj/structure/sign/poster/official/enlist/directional/east,
/obj/machinery/firealarm/directional/north,
/turf/open/floor/iron/dark/diagonal,
/area/station/command/heads_quarters/blueshield)
"q" = (
/obj/structure/cable,
/obj/machinery/atmospherics/pipe/smart/manifold4w/supply/hidden/layer4,
/obj/machinery/atmospherics/pipe/smart/manifold4w/scrubbers/hidden/layer2,
/obj/effect/turf_decal/siding/wood,
/turf/open/floor/wood/parquet,
/area/station/command/heads_quarters/blueshield)
"r" = (
/obj/effect/turf_decal/tile/neutral,
/turf/open/floor/iron,
/area/station/hallway/secondary/exit)
"t" = (
/obj/machinery/holopad,
/turf/open/floor/carpet/blue,
/area/station/command/heads_quarters/blueshield)
"v" = (
/obj/structure/chair/sofa/bench/left{
	dir = 8
	},
/obj/effect/turf_decal/box/corners{
	dir = 8
	},
/obj/effect/turf_decal/box/corners,
/obj/effect/landmark/start/hangover,
/obj/effect/turf_decal/tile/neutral/fourcorners,
/obj/machinery/airalarm/directional/east,
/turf/open/floor/iron/dark,
/area/station/hallway/secondary/exit)
"x" = (
/obj/structure/chair/comfy/black,
/obj/effect/landmark/start/blueshield,
/turf/open/floor/carpet/blue,
/area/station/command/heads_quarters/blueshield)
"y" = (
/obj/structure/cable,
/obj/machinery/atmospherics/pipe/smart/manifold4w/supply/hidden/layer4,
/obj/machinery/atmospherics/pipe/smart/manifold4w/scrubbers/hidden/layer2,
/obj/effect/turf_decal/siding/wood{
	dir = 6
	},
/turf/open/floor/wood/parquet,
/area/station/command/heads_quarters/blueshield)
"z" = (
/obj/structure/cable,
/obj/machinery/door/airlock/maintenance_hatch{
	name = "Maintenance Hatch"
	},
/obj/machinery/atmospherics/pipe/smart/manifold4w/supply/hidden/layer4,
/obj/machinery/atmospherics/pipe/smart/manifold4w/scrubbers/hidden/layer2,
/obj/effect/mapping_helpers/airlock/access/all/command/captain,
/turf/open/floor/iron/dark/textured_large,
/area/station/command/heads_quarters/blueshield)
"A" = (
/obj/structure/chair/sofa/bench/right{
	dir = 8
	},
/obj/effect/turf_decal/box/corners{
	dir = 4
	},
/obj/effect/turf_decal/box/corners{
	dir = 1
	},
/obj/effect/turf_decal/tile/neutral/fourcorners,
/obj/machinery/wall_healer/directional/east,
/obj/machinery/light/directional/east,
/turf/open/floor/iron/dark,
/area/station/hallway/secondary/exit)
"B" = (
/obj/structure/cable,
/obj/effect/turf_decal/siding/wood{
	dir = 8
	},
/turf/open/floor/wood/parquet,
/area/station/command/heads_quarters/blueshield)
"C" = (
/obj/structure/table/wood/fancy/blue,
/obj/item/clipboard{
	pixel_y = 4;
	pixel_x = -3
	},
/obj/item/folder/red{
	pixel_y = 3;
	pixel_x = -1
	},
/obj/item/folder/blue{
	pixel_y = 4;
	pixel_x = 3
	},
/obj/item/sign/flag/nanotrasen,
/obj/structure/sign/poster/official/nanotrasen_logo/directional/east,
/obj/effect/turf_decal/siding/wood{
	dir = 5
	},
/obj/structure/sign/poster/official/enlist/directional/north,
/turf/open/floor/wood/parquet,
/area/station/command/heads_quarters/blueshield)
"D" = (
/obj/structure/cable,
/obj/effect/turf_decal/siding/wood{
	dir = 4
	},
/obj/effect/turf_decal/siding/wood/corner{
	dir = 8
	},
/obj/machinery/atmospherics/pipe/smart/manifold4w/scrubbers/hidden/layer2,
/obj/machinery/atmospherics/pipe/smart/manifold4w/supply/hidden/layer4,
/turf/open/floor/wood/parquet,
/area/station/command/heads_quarters/blueshield)
"E" = (
/obj/machinery/door/airlock/corporate{
	name = "Blueshield's Office"
	},
/obj/effect/mapping_helpers/airlock/access/all/command/captain,
/obj/effect/landmark/navigate_destination/autoname,
/obj/structure/cable,
/obj/machinery/door/firedoor,
/turf/open/floor/iron/dark/textured_large,
/area/station/command/heads_quarters/blueshield)
"F" = (
/obj/structure/cable,
/obj/effect/turf_decal/siding/wood/corner,
/obj/machinery/atmospherics/pipe/smart/manifold4w/scrubbers/hidden/layer2,
/obj/machinery/atmospherics/pipe/smart/manifold4w/supply/hidden/layer4,
/turf/open/floor/wood/parquet,
/area/station/command/heads_quarters/blueshield)
"G" = (
/obj/effect/turf_decal/tile/blue,
/obj/structure/sign/flag/nanotrasen/directional/east,
/turf/open/floor/iron,
/area/station/hallway/secondary/exit)
"H" = (
/obj/structure/hedge,
/obj/machinery/airalarm/directional/north,
/obj/effect/turf_decal/siding/wood{
	dir = 1
	},
/obj/machinery/light/directional/north,
/turf/open/floor/wood/parquet,
/area/station/command/heads_quarters/blueshield)
"I" = (
/obj/effect/landmark/start/assistant,
/obj/structure/chair/sofa/bench{
	dir = 8
	},
/obj/machinery/newscaster/directional/east,
/obj/effect/landmark/start/hangover,
/obj/effect/turf_decal/tile/neutral/fourcorners,
/turf/open/floor/iron/dark,
/area/station/hallway/secondary/exit)
"J" = (
/obj/machinery/firealarm/directional/north,
/obj/effect/turf_decal/siding/wood{
	dir = 9
	},
/obj/structure/hedge,
/turf/open/floor/wood/parquet,
/area/station/command/heads_quarters/blueshield)
"M" = (
/obj/structure/cable,
/obj/effect/turf_decal/siding/wood/end,
/obj/machinery/atmospherics/pipe/smart/manifold4w/scrubbers/hidden/layer2,
/obj/machinery/atmospherics/pipe/smart/manifold4w/supply/hidden/layer4,
/turf/open/floor/wood/parquet,
/area/station/command/heads_quarters/blueshield)
"N" = (
/obj/machinery/power/apc/auto_name/directional/east,
/obj/structure/cable,
/obj/effect/turf_decal/tile/blue,
/turf/open/floor/iron,
/area/station/hallway/secondary/exit)
"O" = (
/obj/machinery/door/firedoor,
/obj/structure/cable,
/obj/machinery/door/airlock/highsecurity{
	name = "Blueshield's Armory"
	},
/obj/effect/mapping_helpers/airlock/access/all/command/captain,
/obj/machinery/atmospherics/pipe/smart/manifold4w/scrubbers/hidden/layer2,
/obj/machinery/atmospherics/pipe/smart/manifold4w/supply/hidden/layer4,
/turf/open/floor/iron/dark/textured_large,
/area/station/command/heads_quarters/blueshield)
"P" = (
/obj/structure/cable,
/obj/machinery/power/apc/auto_name/directional/south,
/obj/effect/turf_decal/siding/thinplating_new/dark{
	dir = 1
	},
/obj/structure/rack/shelf,
/obj/item/storage/toolbox/ammobox/wt550m9,
/obj/machinery/camera/autoname/directional/south,
/turf/open/floor/iron/dark/small,
/area/station/command/heads_quarters/blueshield)
"Q" = (
/obj/machinery/airalarm/directional/south,
/obj/effect/turf_decal/siding/thinplating_new/dark{
	dir = 1
	},
/obj/structure/closet/secure_closet/blueshield,
/turf/open/floor/iron/dark/small,
/area/station/command/heads_quarters/blueshield)
"R" = (
/obj/machinery/light_switch/directional/south,
/obj/effect/turf_decal/siding/wood{
	dir = 10
	},
/turf/open/floor/wood/parquet,
/area/station/command/heads_quarters/blueshield)
"T" = (
/obj/structure/table/reinforced/titaniumglass,
/obj/machinery/recharger{
	pixel_y = 3;
	pixel_x = -6
	},
/obj/item/flashlight/lamp/green{
	pixel_y = 14;
	pixel_x = 5
	},
/obj/item/phone{
	pixel_x = 8;
	pixel_y = -1
	},
/obj/structure/sign/calendar/directional/east,
/turf/open/floor/carpet/blue,
/area/station/command/heads_quarters/blueshield)
"U" = (
/obj/structure/cable,
/obj/machinery/atmospherics/pipe/smart/manifold4w/supply/hidden/layer4,
/obj/effect/turf_decal/siding/wood,
/obj/machinery/atmospherics/pipe/smart/manifold4w/scrubbers/hidden/layer2,
/turf/open/floor/wood/parquet,
/area/station/command/heads_quarters/blueshield)
"V" = (
/obj/machinery/modular_computer/preset/command{
	dir = 1
	},
/obj/machinery/status_display/evac/directional/south,
/obj/machinery/camera/autoname/directional/south,
/turf/open/floor/carpet/blue,
/area/station/command/heads_quarters/blueshield)
"W" = (
/obj/machinery/computer/crew{
	dir = 1
	},
/obj/structure/sign/poster/official/nanotrasen_logo/directional/south,
/turf/open/floor/carpet/blue,
/area/station/command/heads_quarters/blueshield)
"X" = (
/obj/effect/spawner/structure/window/reinforced,
/obj/structure/cable,
/obj/machinery/door/poddoor/shutters/preopen{
	id = "blueshield_priv";
	name = "Privacy Shutters";
	dir = 8
	},
/turf/open/floor/plating,
/area/station/command/heads_quarters/blueshield)
"Y" = (
/obj/effect/turf_decal/siding/thinplating_new/dark{
	dir = 1
	},
/obj/structure/closet/secure_closet/tac{
	req_access = list("captain")
	},
/obj/machinery/status_display/evac/directional/south,
/turf/open/floor/iron/dark/small,
/area/station/command/heads_quarters/blueshield)
"Z" = (
/obj/effect/turf_decal/tile/blue,
/turf/open/floor/iron,
/area/station/hallway/secondary/exit)

(1,1,1) = {"
G
Z
Z
Z
N
r
r
r
r
"}
(2,1,1) = {"
a
X
E
X
a
f
A
I
v
"}
(3,1,1) = {"
a
J
B
R
a
a
a
a
a
"}
(4,1,1) = {"
a
k
F
D
M
O
d
j
a
"}
(5,1,1) = {"
a
H
U
t
W
a
h
P
a
"}
(6,1,1) = {"
a
i
q
x
V
a
c
Q
a
"}
(7,1,1) = {"
a
C
y
T
n
a
o
Y
a
"}
(8,1,1) = {"
a
a
z
a
a
a
a
a
a
"}
