//MAP CONVERTED BY dmm2tgm.py THIS HEADER COMMENT PREVENTS RECONVERSION, DO NOT REMOVE
"e" = (
/obj/effect/turf_decal/siding/wood{
	dir = 9
	},
/turf/open/water/hot_spring,
/area/misc/survivalpod)
"h" = (
/obj/effect/turf_decal/siding/wood{
	dir = 10
	},
/turf/open/water/hot_spring,
/area/misc/survivalpod)
"m" = (
/obj/machinery/door/airlock/wood/glass,
/obj/structure/fans/tiny/invisible,
/obj/machinery/atmospherics/pipe/smart/manifold4w/supply/hidden/layer4,
/obj/machinery/atmospherics/pipe/smart/manifold4w/scrubbers/hidden/layer2,
/turf/open/floor/wood,
/area/misc/survivalpod)
"n" = (
/obj/structure/chair/pew/left{
	dir = 1
	},
/obj/machinery/atmospherics/components/unary/vent_pump/on/layer4,
/turf/open/floor/wood,
/area/misc/survivalpod)
"o" = (
/obj/structure/wall_torch/spawns_lit/directional/north,
/obj/machinery/jukebox/no_access,
/turf/open/floor/wood,
/area/misc/survivalpod)
"p" = (
/obj/structure/wall_torch/spawns_lit/directional/south,
/obj/machinery/atmospherics/pipe/smart/manifold4w/scrubbers/hidden/layer2,
/turf/open/floor/wood,
/area/misc/survivalpod)
"q" = (
/obj/machinery/airalarm/directional/south,
/obj/effect/mapping_helpers/airalarm/unlocked,
/obj/machinery/atmospherics/pipe/smart/manifold4w/supply/hidden/layer4,
/turf/open/floor/wood,
/area/misc/survivalpod)
"s" = (
/obj/structure/wall_torch/spawns_lit/directional/west,
/turf/open/floor/wood,
/area/misc/survivalpod)
"u" = (
/obj/effect/turf_decal/siding/wood{
	dir = 8
	},
/turf/open/water/hot_spring,
/area/misc/survivalpod)
"w" = (
/obj/structure/chair/pew{
	dir = 1
	},
/turf/open/floor/wood,
/area/misc/survivalpod)
"A" = (
/obj/effect/spawner/structure/window,
/turf/open/floor/wood,
/area/misc/survivalpod)
"B" = (
/turf/open/floor/wood,
/area/misc/survivalpod)
"C" = (
/obj/effect/turf_decal/siding/wood{
	dir = 4
	},
/turf/open/water/hot_spring,
/area/misc/survivalpod)
"D" = (
/obj/structure/closet/cabinet,
/obj/item/clothing/under/misc/skyrat/gear_harness,
/obj/item/clothing/under/misc/skyrat/gear_harness,
/obj/item/clothing/under/misc/skyrat/gear_harness,
/obj/item/clothing/under/misc/skyrat/gear_harness,
/obj/item/clothing/under/misc/skyrat/gear_harness,
/obj/item/clothing/under/misc/skyrat/gear_harness,
/obj/item/stack/sheet/mineral/wood/fifty{
	pixel_y = 7
	},
/obj/item/reagent_containers/cup/glass/waterbottle/large{
	pixel_y = 12;
	pixel_x = -8
	},
/obj/structure/wall_torch/spawns_lit/directional/west,
/turf/open/floor/wood,
/area/misc/survivalpod)
"E" = (
/obj/structure/sauna_oven,
/obj/structure/wall_torch/spawns_lit/directional/north,
/turf/open/floor/wood,
/area/misc/survivalpod)
"H" = (
/obj/machinery/atmospherics/pipe/smart/manifold4w/supply/hidden/layer4,
/obj/machinery/atmospherics/pipe/smart/manifold4w/scrubbers/hidden/layer2,
/turf/open/floor/wood,
/area/misc/survivalpod)
"I" = (
/obj/structure/chair/pew/right{
	dir = 1
	},
/obj/machinery/atmospherics/components/unary/vent_scrubber/on/layer2,
/turf/open/floor/wood,
/area/misc/survivalpod)
"K" = (
/obj/structure/table/wood,
/obj/structure/towel_bin{
	pixel_y = 8
	},
/turf/open/floor/wood,
/area/misc/survivalpod)
"M" = (
/turf/closed/wall/mineral/wood,
/area/misc/survivalpod)
"N" = (
/obj/structure/chair/pew/left{
	dir = 4
	},
/turf/open/floor/wood,
/area/misc/survivalpod)
"P" = (
/obj/effect/turf_decal/siding/wood{
	dir = 6
	},
/turf/open/water/hot_spring,
/area/misc/survivalpod)
"T" = (
/obj/effect/spawner/structure/window,
/obj/machinery/light/floor,
/turf/open/floor/wood,
/area/misc/survivalpod)
"V" = (
/obj/machinery/light/floor,
/obj/item/toy/plush/red_mut{
	pixel_x = -4;
	pixel_y = 8
	},
/obj/item/toy/plush/suspicious_protogen{
	pixel_y = 3;
	pixel_x = 5
	},
/obj/structure/table/wood,
/turf/open/floor/wood,
/area/misc/survivalpod)
"X" = (
/obj/effect/turf_decal/siding/wood{
	dir = 5
	},
/turf/open/water/hot_spring,
/area/misc/survivalpod)
"Z" = (
/obj/structure/chair/pew/right{
	dir = 4
	},
/turf/open/floor/wood,
/area/misc/survivalpod)

(1,1,1) = {"
M
M
A
A
M
M
"}
(2,1,1) = {"
A
D
B
B
s
A
"}
(3,1,1) = {"
A
Z
N
n
q
M
"}
(4,1,1) = {"
M
o
K
w
H
m
"}
(5,1,1) = {"
M
E
V
I
p
M
"}
(6,1,1) = {"
A
e
u
u
h
A
"}
(7,1,1) = {"
A
X
C
C
P
A
"}
(8,1,1) = {"
M
A
T
T
A
M
"}
