//MAP CONVERTED BY dmm2tgm.py THIS HEADER COMMENT PREVENTS RECONVERSION, DO NOT REMOVE
"a" = (
/obj/structure/cable,
/obj/machinery/atmospherics/pipe/smart/manifold4w/scrubbers/hidden/layer2,
/obj/machinery/atmospherics/pipe/smart/manifold4w/supply/hidden/layer4,
/obj/machinery/door/firedoor,
/obj/effect/mapping_helpers/airlock/access/all/cent_com/rep_door,
/obj/effect/landmark/navigate_destination/autoname,
/obj/effect/mapping_helpers/airlock/unres{
	dir = 1
	},
/obj/machinery/door/airlock/corporate{
	name = "Nanotrasen Internal Affairs Office"
	},
/turf/open/floor/iron/dark/smooth_large,
/area/station/command/heads_quarters/nt_rep)
"b" = (
/obj/machinery/light/warm/directional/north,
/obj/machinery/status_display/evac/directional/north,
/obj/structure/filingcabinet/employment{
	name = "employment forms filing cabinet"
	},
/obj/structure/filingcabinet/medical{
	pixel_x = -10;
	icon_state = "employmentcabinet";
	name = "medical records filing cabinet"
	},
/obj/structure/filingcabinet/security{
	pixel_x = 10;
	icon_state = "employmentcabinet";
	name = "security records filing cabinet"
	},
/turf/open/floor/carpet/executive,
/area/station/command/heads_quarters/nt_rep)
"c" = (
/obj/effect/turf_decal/siding/wood{
	dir = 8
	},
/turf/open/floor/wood/large,
/area/station/command/heads_quarters/nt_rep)
"e" = (
/obj/machinery/holopad,
/obj/structure/cable,
/turf/open/floor/wood/large,
/area/station/command/heads_quarters/nt_rep)
"f" = (
/obj/item/paper_bin{
	pixel_y = 5;
	pixel_x = -4
	},
/obj/item/stamp{
	pixel_y = 12;
	pixel_x = 8
	},
/obj/item/stamp/denied{
	pixel_x = 8;
	pixel_y = 6
	},
/obj/structure/table/reinforced/titaniumglass,
/obj/item/stamp/nanotrasen{
	pixel_x = 8
	},
/obj/item/pen/fountain/nanotrasen{
	pixel_y = 5;
	pixel_x = -4
	},
/obj/structure/window/reinforced/spawner/directional/east,
/turf/open/floor/carpet/executive,
/area/station/command/heads_quarters/nt_rep)
"g" = (
/obj/structure/cable,
/obj/machinery/modular_computer/preset/command{
	dir = 1
	},
/obj/machinery/keycard_auth/wall_mounted/directional/south,
/turf/open/floor/carpet/executive,
/area/station/command/heads_quarters/nt_rep)
"h" = (
/obj/structure/safe/floor,
/obj/item/clothing/accessory/medal/gold/nanotrasen_consultant,
/obj/item/clothing/accessory/medal/silver/bureaucracy,
/obj/item/clothing/accessory/medal/gold/ordom,
/turf/open/floor/carpet/executive,
/area/station/command/heads_quarters/nt_rep)
"i" = (
/turf/closed/wall/r_wall,
/area/station/command/heads_quarters/nt_rep)
"j" = (
/obj/structure/table/wood/fancy/blue,
/obj/machinery/coffeemaker/impressa{
	pixel_y = 9
	},
/obj/item/storage/fancy/coffee_condi_display{
	pixel_y = -9;
	pixel_x = -3
	},
/obj/item/reagent_containers/cup/glass/mug/nanotrasen{
	pixel_x = 10;
	pixel_y = -1
	},
/obj/item/reagent_containers/cup/glass/mug/nanotrasen{
	pixel_x = 10;
	pixel_y = -7
	},
/turf/open/floor/carpet/executive,
/area/station/command/heads_quarters/nt_rep)
"k" = (
/turf/open/floor/carpet/executive,
/area/station/command/heads_quarters/nt_rep)
"l" = (
/obj/effect/spawner/structure/window/reinforced,
/obj/structure/cable,
/obj/machinery/door/poddoor/shutters/preopen{
	id = "nt_rep_priv";
	name = "Privacy Shutters"
	},
/turf/open/floor/plating,
/area/station/command/heads_quarters/nt_rep)
"m" = (
/obj/structure/chair/comfy/brown{
	dir = 4
	},
/obj/effect/landmark/start/nanotrasen_consultant,
/turf/open/floor/carpet/executive,
/area/station/command/heads_quarters/nt_rep)
"n" = (
/obj/machinery/atmospherics/pipe/smart/manifold4w/supply/hidden/layer4,
/turf/open/floor/wood/large,
/area/station/command/heads_quarters/nt_rep)
"o" = (
/obj/structure/chair/office{
	dir = 1
	},
/obj/structure/cable,
/obj/effect/landmark/start/nanotrasen_crew_trainer,
/turf/open/floor/wood/large,
/area/station/command/heads_quarters/nt_rep)
"p" = (
/obj/structure/table/wood,
/obj/item/paper_bin{
	pixel_y = 5;
	pixel_x = -4
	},
/obj/item/pen{
	pixel_y = 5;
	pixel_x = -4
	},
/obj/item/stamp{
	pixel_y = 9;
	pixel_x = 8
	},
/obj/item/stamp/denied{
	pixel_x = 8;
	pixel_y = 2
	},
/obj/effect/turf_decal/siding/wood{
	dir = 1
	},
/obj/item/radio/intercom/directional/north,
/obj/machinery/camera/autoname/directional/north,
/turf/open/floor/wood/large,
/area/station/command/heads_quarters/nt_rep)
"q" = (
/obj/machinery/atmospherics/components/unary/vent_scrubber/on/layer2{
	dir = 4
	},
/turf/open/floor/wood/large,
/area/station/command/heads_quarters/nt_rep)
"r" = (
/obj/machinery/photocopier/prebuilt,
/obj/effect/turf_decal/siding/wood{
	dir = 9
	},
/obj/structure/sign/poster/official/nanotrasen_logo/directional/north,
/obj/item/toy/plush/skyrat/ian/lisa{
	pixel_y = 11
	},
/turf/open/floor/wood/large,
/area/station/command/heads_quarters/nt_rep)
"s" = (
/obj/machinery/status_display/ai/directional/east,
/obj/structure/closet/secure_closet/nanotrasen_crew_trainer,
/obj/item/storage/lunchbox/nanotrasen,
/obj/effect/turf_decal/siding/wood{
	dir = 4
	},
/turf/open/floor/wood/large,
/area/station/command/heads_quarters/nt_rep)
"t" = (
/obj/structure/extinguisher_cabinet/directional/south,
/obj/machinery/light_switch/directional/east,
/obj/structure/hedge,
/obj/effect/turf_decal/siding/wood{
	dir = 6
	},
/turf/open/floor/wood/large,
/area/station/command/heads_quarters/nt_rep)
"v" = (
/obj/machinery/door/window/brigdoor/left/directional/east{
	name = "Nanotrasen Consultant's Desk";
	req_access = list("cent_general")
	},
/obj/structure/cable,
/turf/open/floor/carpet/executive,
/area/station/command/heads_quarters/nt_rep)
"w" = (
/obj/structure/hedge,
/obj/effect/turf_decal/siding/wood{
	dir = 5
	},
/obj/structure/sign/poster/official/enlist/directional/east,
/obj/machinery/newscaster/directional/north,
/turf/open/floor/wood/large,
/area/station/command/heads_quarters/nt_rep)
"x" = (
/obj/machinery/firealarm/directional/east,
/obj/effect/turf_decal/siding/wood{
	dir = 4
	},
/turf/open/floor/wood/large,
/area/station/command/heads_quarters/nt_rep)
"y" = (
/obj/structure/table/reinforced/titaniumglass,
/obj/structure/window/reinforced/spawner/directional/east,
/obj/item/clipboard{
	pixel_y = 4;
	pixel_x = -3
	},
/obj/item/folder/blue{
	pixel_y = 1
	},
/obj/item/sign/flag/nanotrasen,
/turf/open/floor/carpet/executive,
/area/station/command/heads_quarters/nt_rep)
"z" = (
/obj/structure/hedge,
/obj/structure/noticeboard/directional/west{
	name = "Nanotrasen Consultant's Notice Board"
	},
/obj/structure/sign/calendar/directional/north,
/turf/open/floor/carpet/executive,
/area/station/command/heads_quarters/nt_rep)
"A" = (
/obj/structure/cable,
/obj/machinery/atmospherics/pipe/smart/manifold4w/scrubbers/hidden/layer2,
/obj/machinery/atmospherics/pipe/smart/manifold4w/supply/hidden/layer4,
/obj/effect/turf_decal/siding/wood,
/turf/open/floor/wood/large,
/area/station/command/heads_quarters/nt_rep)
"B" = (
/obj/machinery/modular_computer/preset/time_clock,
/turf/closed/wall/r_wall,
/area/station/command/heads_quarters/nt_rep)
"C" = (
/turf/open/floor/wood/large,
/area/station/command/heads_quarters/nt_rep)
"D" = (
/obj/structure/cable,
/obj/structure/aquarium/prefilled,
/obj/machinery/requests_console/directional/south{
	name = "Nanotrasen Consultant's Requests Console";
	department = "Nanotrasen Consultant's Desk"
	},
/obj/effect/mapping_helpers/requests_console/announcement,
/obj/effect/mapping_helpers/requests_console/assistance,
/obj/effect/mapping_helpers/requests_console/information,
/obj/item/reagent_containers/cup/fish_feed{
	pixel_y = 17;
	pixel_x = -3
	},
/turf/open/floor/carpet/executive,
/area/station/command/heads_quarters/nt_rep)
"E" = (
/obj/structure/chair/wood{
	dir = 8
	},
/obj/effect/turf_decal/siding/wood{
	dir = 8
	},
/turf/open/floor/wood/large,
/area/station/command/heads_quarters/nt_rep)
"F" = (
/obj/structure/cable,
/obj/effect/turf_decal/siding/wood{
	dir = 10
	},
/turf/open/floor/wood/large,
/area/station/command/heads_quarters/nt_rep)
"G" = (
/obj/machinery/atmospherics/components/unary/vent_pump/on/layer4,
/turf/open/floor/wood/large,
/area/station/command/heads_quarters/nt_rep)
"H" = (
/obj/structure/cable,
/turf/open/floor/wood/large,
/area/station/command/heads_quarters/nt_rep)
"I" = (
/obj/effect/turf_decal/siding/wood{
	dir = 1
	},
/obj/machinery/airalarm/directional/north,
/obj/machinery/computer/station_goal,
/turf/open/floor/wood/large,
/area/station/command/heads_quarters/nt_rep)
"J" = (
/obj/structure/table/wood/fancy/blue,
/obj/machinery/fax{
	fax_name = "Nanotrasen Consultant's Office";
	name = "Nanotrasen Consultant's Fax Machine"
	},
/turf/open/floor/carpet/executive,
/area/station/command/heads_quarters/nt_rep)
"K" = (
/obj/structure/bed/dogbed/ian{
	name = "Lisa's bed";
	desc = "Lisa's bed! Looks comfy."
	},
/mob/living/basic/pet/dog/corgi/lisa,
/obj/effect/turf_decal/siding/wood,
/turf/open/floor/wood/large,
/area/station/command/heads_quarters/nt_rep)
"L" = (
/obj/effect/turf_decal/siding/wood{
	dir = 4
	},
/turf/open/floor/wood/large,
/area/station/command/heads_quarters/nt_rep)
"M" = (
/obj/effect/turf_decal/siding/wood,
/turf/open/floor/wood/large,
/area/station/command/heads_quarters/nt_rep)
"O" = (
/obj/structure/table/reinforced/titaniumglass,
/obj/structure/cable,
/obj/structure/window/reinforced/spawner/directional/east,
/obj/machinery/recharger{
	pixel_y = 3;
	pixel_x = -6
	},
/obj/item/flashlight/lamp/green{
	pixel_y = 14;
	pixel_x = 5
	},
/obj/item/phone{
	pixel_x = 8;
	pixel_y = -1
	},
/turf/open/floor/carpet/executive,
/area/station/command/heads_quarters/nt_rep)
"P" = (
/obj/effect/turf_decal/siding/wood{
	dir = 8
	},
/obj/structure/cable,
/turf/open/floor/wood/large,
/area/station/command/heads_quarters/nt_rep)
"Q" = (
/obj/machinery/door/airlock/maintenance,
/obj/effect/mapping_helpers/airlock/access/all/cent_com/rep_door,
/turf/open/floor/iron/dark/smooth_large,
/area/station/command/heads_quarters/nt_rep)
"R" = (
/obj/machinery/light/warm/directional/north,
/obj/structure/table/wood,
/obj/item/clipboard{
	pixel_y = 3;
	pixel_x = 2
	},
/obj/item/folder/yellow{
	pixel_y = 1;
	pixel_x = -2
	},
/obj/machinery/status_display/ai/directional/north,
/obj/effect/turf_decal/siding/wood{
	dir = 1
	},
/turf/open/floor/wood/large,
/area/station/command/heads_quarters/nt_rep)
"S" = (
/obj/effect/spawner/structure/window/reinforced,
/obj/structure/cable,
/obj/machinery/door/poddoor/shutters/preopen{
	id = "nt_rep_priv";
	dir = 8;
	name = "Privacy Shutters"
	},
/turf/open/floor/plating,
/area/station/command/heads_quarters/nt_rep)
"T" = (
/obj/structure/sign/flag/nanotrasen,
/turf/closed/wall/r_wall,
/area/station/command/heads_quarters/nt_rep)
"U" = (
/obj/machinery/atmospherics/pipe/smart/manifold4w/supply/hidden/layer4,
/obj/effect/landmark/start/nanotrasen_crew_trainer,
/turf/open/floor/wood/large,
/area/station/command/heads_quarters/nt_rep)
"W" = (
/obj/structure/cable,
/obj/machinery/atmospherics/pipe/smart/manifold4w/scrubbers/hidden/layer2,
/obj/machinery/atmospherics/pipe/smart/manifold4w/supply/hidden/layer4,
/turf/open/floor/wood/large,
/area/station/command/heads_quarters/nt_rep)
"X" = (
/obj/structure/window/reinforced/spawner/directional/east,
/obj/structure/hedge,
/obj/machinery/power/apc/auto_name/directional/north,
/obj/structure/cable,
/turf/open/floor/carpet/executive,
/area/station/command/heads_quarters/nt_rep)
"Z" = (
/obj/machinery/button/door/directional/west{
	id = "nt_rep_priv";
	name = "Privacy Shutters Control";
	req_access = list("cent_general")
	},
/obj/structure/closet/secure_closet/nanotrasen_consultant,
/turf/open/floor/carpet/executive,
/area/station/command/heads_quarters/nt_rep)

(1,1,1) = {"
i
i
i
S
S
S
i
"}
(2,1,1) = {"
i
z
Z
j
J
D
i
"}
(3,1,1) = {"
i
b
k
h
m
g
i
"}
(4,1,1) = {"
i
X
v
f
y
O
T
"}
(5,1,1) = {"
i
r
P
c
E
F
l
"}
(6,1,1) = {"
i
p
H
C
q
M
l
"}
(7,1,1) = {"
i
I
o
e
W
A
a
"}
(8,1,1) = {"
i
R
G
n
U
K
B
"}
(9,1,1) = {"
i
w
s
L
x
t
i
"}
(10,1,1) = {"
i
i
i
Q
i
i
i
"}
