//MAP CONVERTED BY dmm2tgm.py THIS HEADER COMMENT PREVENTS RECONVERSION, DO NOT REMOVE
"a" = (
/obj/structure/cable,
/obj/effect/turf_decal/siding/wood{
	dir = 10
	},
/obj/machinery/atmospherics/pipe/smart/manifold4w/supply/hidden/layer4,
/obj/machinery/atmospherics/pipe/smart/manifold4w/scrubbers/hidden/layer2,
/obj/machinery/light_switch/directional/south,
/turf/open/floor/wood/parquet,
/area/station/command/heads_quarters/blueshield)
"b" = (
/obj/structure/bed/double{
	dir = 1
	},
/obj/item/bedsheet/nanotrasen/double{
	dir = 1
	},
/obj/structure/sign/clock/directional/north,
/turf/open/floor/carpet/blue,
/area/station/command/heads_quarters/blueshield)
"c" = (
/obj/effect/turf_decal/siding/thinplating_new/dark{
	dir = 4
	},
/obj/structure/rack/shelf,
/obj/structure/sign/poster/official/nanotrasen_logo/directional/west,
/obj/item/storage/medkit/brute,
/obj/item/storage/medkit/fire{
	pixel_y = 4
	},
/turf/open/floor/iron/dark/small,
/area/station/command/heads_quarters/blueshield)
"d" = (
/obj/effect/turf_decal/siding/wood/end{
	dir = 4
	},
/obj/effect/landmark/start/blueshield,
/turf/open/floor/wood/parquet,
/area/station/command/heads_quarters/blueshield)
"e" = (
/obj/effect/turf_decal/siding/wood{
	dir = 6
	},
/obj/structure/grandfatherclock,
/turf/open/floor/wood/parquet,
/area/station/command/heads_quarters/blueshield)
"f" = (
/turf/template_noop,
/area/template_noop)
"g" = (
/obj/structure/cable,
/obj/machinery/holopad,
/obj/machinery/atmospherics/pipe/smart/manifold4w/supply/hidden/layer4,
/obj/machinery/atmospherics/pipe/smart/manifold4w/scrubbers/hidden/layer2,
/turf/open/floor/carpet/blue,
/area/station/command/heads_quarters/blueshield)
"i" = (
/obj/item/radio/intercom/directional/south,
/obj/structure/cable,
/obj/machinery/atmospherics/pipe/smart/manifold4w/supply/hidden/layer4,
/obj/machinery/atmospherics/pipe/smart/manifold4w/scrubbers/hidden/layer2,
/turf/open/floor/carpet,
/area/station/command/heads_quarters/captain)
"j" = (
/obj/structure/cable,
/obj/machinery/atmospherics/pipe/smart/manifold4w/supply/hidden/layer4,
/obj/machinery/atmospherics/pipe/smart/manifold4w/scrubbers/hidden/layer2,
/turf/open/floor/wood,
/area/station/command/heads_quarters/captain)
"k" = (
/obj/structure/extinguisher_cabinet/directional/east,
/obj/structure/table/wood,
/obj/item/storage/box/coffeepack{
	pixel_x = 8;
	pixel_y = 12
	},
/obj/item/reagent_containers/cup/glass/mug{
	pixel_x = -1;
	pixel_y = 8
	},
/obj/item/reagent_containers/cup/glass/mug{
	pixel_x = -3;
	pixel_y = 2
	},
/turf/open/floor/carpet,
/area/station/command/heads_quarters/captain)
"l" = (
/obj/structure/table/reinforced/titaniumglass,
/obj/machinery/recharger{
	pixel_y = 3;
	pixel_x = -6
	},
/obj/item/flashlight/lamp/green{
	pixel_y = 14;
	pixel_x = 5
	},
/obj/item/phone{
	pixel_x = 8;
	pixel_y = -1
	},
/obj/machinery/atmospherics/components/unary/vent_scrubber/on/layer2{
	dir = 1
	},
/turf/open/floor/carpet/blue,
/area/station/command/heads_quarters/blueshield)
"m" = (
/obj/machinery/computer/crew{
	dir = 8
	},
/obj/structure/sign/calendar/directional/east,
/turf/open/floor/carpet/blue,
/area/station/command/heads_quarters/blueshield)
"n" = (
/obj/effect/turf_decal/siding/wood{
	dir = 5
	},
/obj/machinery/atmospherics/components/unary/vent_pump/on/layer4,
/obj/machinery/newscaster/directional/north,
/turf/open/floor/wood/parquet,
/area/station/command/heads_quarters/blueshield)
"o" = (
/obj/structure/cable,
/obj/machinery/door/airlock/corporate{
	name = "Blueshield's Office"
	},
/obj/machinery/atmospherics/pipe/smart/manifold4w/supply/hidden/layer4,
/obj/machinery/atmospherics/pipe/smart/manifold4w/scrubbers/hidden/layer2,
/obj/effect/mapping_helpers/airlock/access/all/command/captain,
/obj/machinery/door/firedoor,
/obj/effect/landmark/navigate_destination/autoname,
/turf/open/floor/iron/dark/textured_large,
/area/station/command/heads_quarters/blueshield)
"p" = (
/obj/machinery/modular_computer/preset/command{
	dir = 8
	},
/obj/machinery/status_display/evac/directional/east,
/turf/open/floor/carpet/blue,
/area/station/command/heads_quarters/blueshield)
"q" = (
/turf/closed/wall/r_wall,
/area/station/command/heads_quarters/captain/private)
"r" = (
/obj/structure/table/wood,
/obj/machinery/atmospherics/pipe/smart/manifold4w/supply/hidden/layer4,
/obj/structure/cable,
/obj/machinery/atmospherics/pipe/smart/manifold4w/scrubbers/hidden/layer2,
/turf/open/floor/carpet,
/area/station/command/heads_quarters/captain)
"s" = (
/turf/closed/wall/r_wall,
/area/station/command/heads_quarters/captain)
"t" = (
/obj/structure/dresser,
/obj/effect/turf_decal/siding/wood/end{
	dir = 8
	},
/obj/item/sign/flag/nanotrasen{
	pixel_y = 11
	},
/turf/open/floor/wood/parquet,
/area/station/command/heads_quarters/blueshield)
"u" = (
/obj/effect/turf_decal/siding/thinplating_new/dark{
	dir = 4
	},
/obj/machinery/power/apc/auto_name/directional/north,
/obj/structure/cable,
/obj/structure/rack/shelf,
/obj/item/storage/toolbox/ammobox/wt550m9,
/turf/open/floor/iron/dark/small,
/area/station/command/heads_quarters/blueshield)
"v" = (
/obj/machinery/atmospherics/components/unary/vent_pump/on/layer4{
	dir = 8
	},
/turf/open/floor/carpet,
/area/station/command/heads_quarters/captain)
"w" = (
/obj/structure/cable,
/obj/machinery/light/warm/directional/north,
/obj/machinery/atmospherics/pipe/smart/manifold4w/supply/hidden/layer4,
/obj/machinery/atmospherics/pipe/smart/manifold4w/scrubbers/hidden/layer2,
/obj/machinery/airalarm/directional/north,
/obj/machinery/camera/directional/north{
	c_tag = "Blueshield's Office"
	},
/turf/open/floor/carpet/blue,
/area/station/command/heads_quarters/blueshield)
"y" = (
/obj/structure/cable,
/obj/structure/table/reinforced/titaniumglass,
/obj/item/paper_bin{
	pixel_y = 5;
	pixel_x = -4
	},
/obj/item/pen/fountain/nanotrasen{
	pixel_y = 5;
	pixel_x = -4
	},
/obj/item/stamp{
	pixel_y = 10;
	pixel_x = 8
	},
/obj/item/stamp/denied{
	pixel_x = 8;
	pixel_y = 3
	},
/turf/open/floor/carpet/blue,
/area/station/command/heads_quarters/blueshield)
"z" = (
/obj/structure/cable,
/obj/effect/turf_decal/siding/wood{
	dir = 8
	},
/obj/machinery/atmospherics/pipe/smart/manifold4w/supply/hidden/layer4,
/obj/machinery/atmospherics/pipe/smart/manifold4w/scrubbers/hidden/layer2,
/obj/machinery/firealarm/directional/west,
/turf/open/floor/wood/parquet,
/area/station/command/heads_quarters/blueshield)
"A" = (
/obj/structure/window/reinforced/spawner/directional/south,
/obj/structure/table/wood,
/obj/item/radio/intercom/directional/east,
/obj/machinery/fax{
	name = "Captain's Fax Machine";
	fax_name = "Captain's Office"
	},
/turf/open/floor/wood,
/area/station/command/heads_quarters/captain)
"B" = (
/obj/machinery/light/warm/directional/north,
/obj/machinery/airalarm/directional/north,
/obj/structure/sign/poster/official/nanotrasen_logo/directional/east,
/turf/open/floor/carpet/blue,
/area/station/command/heads_quarters/blueshield)
"C" = (
/obj/structure/chair/comfy/brown,
/obj/structure/cable,
/obj/machinery/atmospherics/pipe/smart/manifold4w/scrubbers/hidden/layer2,
/turf/open/floor/carpet,
/area/station/command/heads_quarters/captain)
"D" = (
/obj/structure/cable,
/obj/effect/turf_decal/tile/blue/diagonal_centre,
/obj/machinery/light/red/directional/north,
/obj/machinery/atmospherics/components/unary/vent_pump/on/layer4,
/obj/machinery/status_display/ai/directional/north,
/obj/effect/landmark/start/blueshield,
/obj/machinery/camera/directional/north{
	c_tag = "Blueshield's Office - Armory"
	},
/turf/open/floor/iron/dark/diagonal,
/area/station/command/heads_quarters/blueshield)
"E" = (
/obj/machinery/computer/security{
	dir = 8
	},
/obj/machinery/button/door/directional/east{
	id = "blueshield_priv";
	req_access = list("captain");
	name = "Privacy Shutters Control"
	},
/obj/item/radio/intercom/directional/south,
/turf/open/floor/carpet/blue,
/area/station/command/heads_quarters/blueshield)
"F" = (
/obj/structure/chair/comfy/brown{
	dir = 1
	},
/obj/structure/cable,
/obj/machinery/atmospherics/pipe/smart/manifold4w/supply/hidden/layer4,
/obj/machinery/atmospherics/pipe/smart/manifold4w/scrubbers/hidden/layer2,
/turf/open/floor/carpet,
/area/station/command/heads_quarters/captain)
"G" = (
/obj/machinery/airalarm/directional/east,
/obj/machinery/camera/directional/east{
	c_tag = "Command - Captain's Office"
	},
/obj/structure/table/wood,
/obj/machinery/coffeemaker/impressa,
/turf/open/floor/carpet,
/area/station/command/heads_quarters/captain)
"H" = (
/obj/structure/cable,
/obj/effect/turf_decal/siding/wood{
	dir = 4
	},
/obj/machinery/atmospherics/pipe/smart/manifold4w/supply/hidden/layer4,
/obj/machinery/atmospherics/pipe/smart/manifold4w/scrubbers/hidden/layer2,
/turf/open/floor/wood/parquet,
/area/station/command/heads_quarters/blueshield)
"I" = (
/obj/structure/chair/comfy/black{
	dir = 4
	},
/obj/machinery/atmospherics/pipe/smart/manifold4w/scrubbers/hidden/layer2,
/obj/effect/landmark/start/blueshield,
/turf/open/floor/carpet/blue,
/area/station/command/heads_quarters/blueshield)
"J" = (
/turf/open/floor/carpet,
/area/station/command/heads_quarters/captain)
"K" = (
/obj/effect/turf_decal/siding/thinplating_new/dark{
	dir = 8
	},
/obj/structure/closet/secure_closet/blueshield,
/obj/structure/sign/poster/official/enlist/directional/east,
/obj/machinery/firealarm/directional/south,
/turf/open/floor/iron/dark/small,
/area/station/command/heads_quarters/blueshield)
"L" = (
/obj/machinery/requests_console/directional/east{
	name = "Captain's Requests Console";
	department = "Captain's Desk"
	},
/obj/effect/mapping_helpers/requests_console/announcement,
/obj/effect/mapping_helpers/requests_console/assistance,
/obj/machinery/computer/communications{
	dir = 8
	},
/turf/open/floor/wood,
/area/station/command/heads_quarters/captain)
"M" = (
/obj/machinery/door/airlock/command{
	name = "Captain's Quarters"
	},
/obj/effect/mapping_helpers/airlock/access/all/command/captain,
/obj/structure/cable,
/obj/machinery/atmospherics/pipe/smart/manifold4w/supply/hidden/layer4,
/obj/machinery/atmospherics/pipe/smart/manifold4w/scrubbers/hidden/layer2,
/turf/open/floor/wood,
/area/station/command/heads_quarters/captain/private)
"N" = (
/obj/structure/cable,
/obj/machinery/atmospherics/pipe/smart/manifold4w/supply/hidden/layer4,
/obj/machinery/atmospherics/pipe/smart/manifold4w/scrubbers/hidden/layer2,
/obj/structure/sign/flag/nanotrasen/directional/south,
/turf/open/floor/carpet,
/area/station/command/heads_quarters/captain)
"O" = (
/obj/machinery/door/airlock/corporate{
	name = "Blueshield's Quarters"
	},
/obj/effect/mapping_helpers/airlock/access/all/command/captain,
/turf/open/floor/iron/dark/textured_large,
/area/station/command/heads_quarters/blueshield)
"P" = (
/turf/closed/wall/r_wall,
/area/station/command/heads_quarters/blueshield)
"Q" = (
/obj/structure/cable,
/obj/effect/turf_decal/tile/blue/diagonal_centre,
/obj/machinery/atmospherics/pipe/smart/manifold4w/supply/hidden/layer4,
/obj/machinery/atmospherics/components/unary/vent_scrubber/on/layer2,
/turf/open/floor/iron/dark/diagonal,
/area/station/command/heads_quarters/blueshield)
"R" = (
/obj/structure/cable,
/obj/machinery/door/airlock/highsecurity{
	name = "Blueshield's Armory"
	},
/obj/machinery/atmospherics/pipe/smart/manifold4w/supply/hidden/layer4,
/obj/machinery/atmospherics/pipe/smart/manifold4w/scrubbers/hidden/layer2,
/obj/effect/mapping_helpers/airlock/access/all/command/captain,
/obj/machinery/door/firedoor,
/turf/open/floor/iron/dark/textured_large,
/area/station/command/heads_quarters/blueshield)
"S" = (
/obj/machinery/door/poddoor/shutters/preopen{
	id = "blueshield_priv";
	name = "Privacy Shutters"
	},
/obj/effect/spawner/structure/window/reinforced,
/obj/structure/cable,
/turf/open/floor/plating,
/area/station/command/heads_quarters/blueshield)
"U" = (
/obj/effect/landmark/start/captain,
/obj/structure/chair/office,
/obj/structure/cable,
/obj/machinery/atmospherics/pipe/smart/manifold4w/scrubbers/hidden/layer2,
/turf/open/floor/wood,
/area/station/command/heads_quarters/captain)
"V" = (
/obj/structure/table/wood,
/obj/item/folder/blue,
/obj/item/stamp/head/captain,
/obj/machinery/door/window/right/directional/south{
	name = "Captain's Desk";
	req_access = list("captain")
	},
/obj/structure/cable,
/obj/machinery/atmospherics/pipe/smart/manifold4w/scrubbers/hidden/layer2,
/turf/open/floor/wood,
/area/station/command/heads_quarters/captain)
"W" = (
/obj/structure/cable,
/obj/machinery/atmospherics/pipe/smart/manifold4w/supply/hidden/layer4,
/obj/machinery/atmospherics/pipe/smart/manifold4w/scrubbers/hidden/layer2,
/turf/open/floor/carpet/blue,
/area/station/command/heads_quarters/blueshield)
"X" = (
/obj/effect/turf_decal/siding/wood{
	dir = 9
	},
/obj/structure/extinguisher_cabinet/directional/west,
/turf/open/floor/wood/parquet,
/area/station/command/heads_quarters/blueshield)
"Y" = (
/obj/machinery/keycard_auth/wall_mounted/directional/north{
	pixel_x = 26
	},
/obj/machinery/status_display/ai/directional/north,
/obj/item/radio/intercom/command/directional/east,
/obj/structure/bed/dogbed/renault,
/mob/living/basic/pet/fox/renault,
/turf/open/floor/wood,
/area/station/command/heads_quarters/captain)
"Z" = (
/obj/effect/turf_decal/siding/thinplating_new/dark{
	dir = 8
	},
/obj/structure/closet/secure_closet/tac{
	req_access = list("captain")
	},
/obj/machinery/airalarm/directional/north,
/obj/item/clothing/suit/armor/riot,
/obj/item/clothing/head/helmet/toggleable/riot,
/turf/open/floor/iron/dark/small,
/area/station/command/heads_quarters/blueshield)

(1,1,1) = {"
M
j
U
V
C
r
F
s
"}
(2,1,1) = {"
q
Y
L
A
J
v
i
s
"}
(3,1,1) = {"
P
P
P
P
G
k
N
s
"}
(4,1,1) = {"
P
b
t
P
P
P
o
P
"}
(5,1,1) = {"
P
B
d
O
X
z
a
P
"}
(6,1,1) = {"
P
P
P
P
n
H
e
S
"}
(7,1,1) = {"
P
u
c
P
w
g
y
S
"}
(8,1,1) = {"
P
D
Q
R
W
I
l
S
"}
(9,1,1) = {"
P
Z
K
P
m
p
E
P
"}
(10,1,1) = {"
P
P
P
P
P
P
P
P
"}
(11,1,1) = {"
f
f
f
f
f
f
f
f
"}
