//MAP CONVERTED BY dmm2tgm.py THIS HEADER COMMENT PREVENTS RECONVERSION, DO NOT REMOVE
"aa" = (
/obj/effect/spawner/structure/window/reinforced,
/obj/machinery/door/poddoor/preopen{
	id = "nt_rep_priv";
	name = "Privacy Shutter"
	},
/turf/open/floor/plating,
/area/station/command/heads_quarters/nt_rep)
"ab" = (
/obj/structure/chair/comfy/beige,
/turf/open/floor/wood,
/area/station/command/heads_quarters/nt_rep)
"ac" = (
/obj/machinery/holopad,
/turf/open/floor/wood/large,
/area/station/command/heads_quarters/nt_rep)
"ad" = (
/turf/closed/wall/r_wall,
/area/station/maintenance/port)
"ae" = (
/obj/effect/turf_decal/siding/wood{
	dir = 4
	},
/obj/effect/turf_decal/siding/wood{
	dir = 1
	},
/turf/open/floor/carpet/green,
/area/station/command/heads_quarters/nt_rep)
"af" = (
/obj/structure/table/wood,
/obj/item/table_clock{
	pixel_y = 5
	},
/turf/open/floor/wood,
/area/station/command/heads_quarters/nt_rep)
"ag" = (
/obj/structure/table/wood,
/obj/item/statuebust/hippocratic{
	pixel_y = 8
	},
/turf/open/floor/wood,
/area/station/command/heads_quarters/nt_rep)
"ah" = (
/obj/structure/filingcabinet,
/obj/structure/filingcabinet/medical{
	pixel_x = -10
	},
/obj/structure/filingcabinet/security{
	pixel_x = 10
	},
/obj/effect/turf_decal/siding/dark,
/turf/open/floor/carpet/green,
/area/station/command/heads_quarters/nt_rep)
"ai" = (
/obj/structure/bed/dogbed,
/mob/living/basic/mothroach{
	name = "CMO";
	desc = "Prefers to chew on carpet, watch the Consultant, and be regularly patted."
	},
/obj/machinery/light/directional/east,
/turf/open/floor/wood,
/area/station/command/heads_quarters/nt_rep)
"aj" = (
/obj/structure/sign/poster/official/random/directional/south,
/obj/effect/landmark/start/nanotrasen_consultant,
/obj/structure/chair/office/tactical{
	dir = 1
	},
/turf/open/floor/carpet/green,
/area/station/command/heads_quarters/nt_rep)
"ak" = (
/obj/machinery/atmospherics/pipe/smart/manifold4w/scrubbers/hidden/layer2,
/turf/open/floor/wood,
/area/station/command/heads_quarters/nt_rep)
"al" = (
/obj/structure/cable,
/turf/open/floor/wood,
/area/station/command/heads_quarters/nt_rep)
"am" = (
/obj/merge_conflict_marker{
	name = "---Merge Conflict Marker---";
	
	desc = "A best-effort merge was performed. You must resolve this conflict yourself (manually) and remove this object once complete."
	},
/obj/machinery/door/airlock/corporate{
	name = "NT Consultant's Office"
	},
/obj/effect/mapping_helpers/airlock/access/all/cent_com/rep_door,
/obj/machinery/door/firedoor,
/obj/effect/turf_decal/siding/wood,
/obj/effect/mapping_helpers/airlock/unres/delayed{
	dir = 1
	},
/turf/open/floor/wood/large,
/area/station/command/heads_quarters/nt_rep)
"an" = (
/obj/structure/chair/comfy/beige,
/obj/machinery/firealarm/directional/west,
/turf/open/floor/wood,
/area/station/command/heads_quarters/nt_rep)
"ao" = (
/obj/structure/table/wood,
/obj/item/pen/fountain{
	pixel_x = -5
	},
/obj/item/paper_bin{
	pixel_y = 4;
	pixel_x = -5
	},
/obj/item/stamp/centcom{
	pixel_x = 8
	},
/obj/item/stamp/denied{
	pixel_x = 8;
	pixel_y = 6
	},
/obj/item/stamp/granted{
	pixel_y = 12;
	pixel_x = 8
	},
/obj/effect/turf_decal/siding/wood{
	dir = 1
	},
/turf/open/floor/carpet/green,
/area/station/command/heads_quarters/nt_rep)
"ap" = (
/obj/effect/turf_decal/tile/neutral{
	dir = 8
	},
/turf/open/floor/iron,
/area/station/hallway/primary/port)
"aq" = (
/turf/closed/wall,
/area/station/command/heads_quarters/nt_rep)
"ar" = (
/obj/structure/bed/dogbed,
/mob/living/basic/mothroach{
	name = "CMO";
	desc = "Prefers to chew on carpet, watch the Consultant, and be regularly patted."
	},
/obj/machinery/light/directional/east,
/turf/open/floor/wood/large,
/area/station/command/heads_quarters/nt_rep)
"as" = (
/obj/machinery/atmospherics/components/unary/vent_scrubber/on/layer2{
	dir = 4
	},
/obj/machinery/light/directional/west,
/turf/open/floor/wood,
/area/station/command/heads_quarters/nt_rep)
"at" = (
/obj/machinery/airalarm/directional/south,
/obj/machinery/atmospherics/components/unary/vent_pump/on/layer4{
	dir = 8
	},
/turf/open/floor/wood/large,
/area/station/command/heads_quarters/nt_rep)
"au" = (
/obj/machinery/atmospherics/pipe/smart/manifold4w/supply/hidden/layer4,
/turf/open/floor/wood,
/area/station/command/heads_quarters/nt_rep)
"av" = (
/obj/machinery/camera/directional/west{
	c_tag = "NT Consultant's Office";
	name = "command camera"
	},
/obj/structure/cable,
/obj/machinery/power/apc/auto_name/directional/west,
/turf/open/floor/wood,
/area/station/command/heads_quarters/nt_rep)
"aw" = (
/obj/effect/turf_decal/tile/neutral{
	dir = 8
	},
/obj/item/banner{
	inspiration_available = 0
	},
/turf/open/floor/iron,
/area/station/hallway/primary/port)
"ax" = (
/obj/machinery/light/directional/west,
/obj/machinery/modular_computer/preset/command{
	dir = 4
	},
/obj/structure/sign/calendar/directional/west,
/turf/open/floor/carpet/green,
/area/station/command/heads_quarters/nt_rep)
"ay" = (
/obj/machinery/firealarm/directional/east,
/obj/item/bedsheet/centcom/double,
/obj/structure/bed/double,
/obj/machinery/light/small/blacklight/directional/east{
	desc = "A small lighting fixture. Why is this here?"
	},
/turf/open/floor/carpet/green,
/area/station/command/heads_quarters/nt_rep)
"az" = (
/obj/machinery/holopad,
/turf/open/floor/wood,
/area/station/command/heads_quarters/nt_rep)
"aA" = (
/obj/structure/closet/secure_closet/nanotrasen_consultant,
/turf/open/floor/carpet/green,
/area/station/command/heads_quarters/nt_rep)
"aB" = (
/obj/structure/table/wood,
/obj/item/pen/fountain{
	pixel_x = -5
	},
/obj/item/paper_bin{
	pixel_y = 4;
	pixel_x = -5
	},
/obj/item/stamp/centcom{
	pixel_x = 8
	},
/obj/item/stamp/denied{
	pixel_x = 8;
	pixel_y = 6
	},
/obj/item/stamp{
	pixel_y = 12;
	pixel_x = 8
	},
/obj/effect/turf_decal/siding/wood{
	dir = 1
	},
/turf/open/floor/carpet/green,
/area/station/command/heads_quarters/nt_rep)
"aC" = (
/obj/structure/cable,
/obj/machinery/atmospherics/pipe/smart/manifold4w/scrubbers/hidden/layer2,
/obj/effect/turf_decal/siding/wood{
	dir = 4
	},
/obj/machinery/light_switch/directional/east,
/turf/open/floor/wood,
/area/station/command/heads_quarters/nt_rep)
"aD" = (
/turf/template_noop,
/area/template_noop)
"aE" = (
/obj/machinery/airalarm/directional/south,
/obj/machinery/atmospherics/components/unary/vent_pump/on/layer4{
	dir = 8
	},
/turf/open/floor/wood,
/area/station/command/heads_quarters/nt_rep)
"aF" = (
/obj/structure/cable,
/obj/machinery/atmospherics/pipe/smart/manifold4w/scrubbers/hidden/layer2,
/obj/effect/turf_decal/siding/wood/corner,
/obj/machinery/status_display/ai/directional/east,
/turf/open/floor/wood,
/area/station/command/heads_quarters/nt_rep)
"aG" = (
/obj/machinery/atmospherics/pipe/smart/manifold4w/supply/hidden/layer4,
/obj/effect/mapping_helpers/airlock/access/all/cent_com/rep_door,
/obj/machinery/door/airlock/maintenance,
/obj/effect/turf_decal/siding/wood{
	dir = 7
	},
/obj/effect/mapping_helpers/airlock/unres/delayed{
	dir = 1
	},
/turf/open/floor/wood,
/area/station/maintenance/port)
"aH" = (
/obj/machinery/vending/boozeomat,
/turf/closed/wall/r_wall,
/area/station/command/heads_quarters/nt_rep)
"aI" = (
/obj/effect/turf_decal/siding/wood{
	dir = 1
	},
/obj/machinery/fax{
	fax_name = "Nanotrasen Consultant's Office";
	name = "Nanotrasen Consultant's Fax Machine"
	},
/obj/structure/table/wood,
/obj/machinery/button/door/directional/west{
	id = "nt_rep_priv";
	name = "Privacy Shutters Control";
	pixel_y = 8
	},
/turf/open/floor/carpet/green,
/area/station/command/heads_quarters/nt_rep)
"aJ" = (
/obj/structure/chair/comfy/beige,
/obj/machinery/firealarm/directional/west,
/turf/open/floor/wood/large,
/area/station/command/heads_quarters/nt_rep)
"aK" = (
/obj/machinery/photocopier/prebuilt,
/turf/open/floor/wood/large,
/area/station/command/heads_quarters/nt_rep)
"aL" = (
/turf/open/floor/carpet/green,
/area/station/command/heads_quarters/nt_rep)
"aM" = (
/obj/machinery/modular_computer/preset/time_clock/directional/south,
/turf/open/floor/iron,
/area/station/hallway/primary/port)
"aN" = (
/obj/effect/turf_decal/siding/wood{
	dir = 4
	},
/obj/structure/cable,
/obj/structure/sign/flag/galfed/directional/east,
/turf/open/floor/wood,
/area/station/command/heads_quarters/nt_rep)
"aO" = (
/obj/item/radio/intercom/directional/south,
/obj/effect/turf_decal/siding/wood{
	dir = 4
	},
/turf/open/floor/carpet/green,
/area/station/command/heads_quarters/nt_rep)
"aP" = (
/obj/machinery/door/airlock/corporate{
	name = "NT Consultant's Office"
	},
/obj/effect/mapping_helpers/airlock/access/all/cent_com/rep_door,
/obj/machinery/door/firedoor,
/obj/effect/turf_decal/siding/wood,
/obj/effect/mapping_helpers/airlock/unres{
	dir = 1
	},
/turf/open/floor/carpet/green,
/area/station/command/heads_quarters/nt_rep)
"aQ" = (
/obj/machinery/door/airlock/corporate{
	name = "NT Consultant's Office"
	},
/obj/structure/cable,
/obj/machinery/atmospherics/pipe/smart/manifold4w/scrubbers/hidden/layer2,
/obj/effect/mapping_helpers/airlock/access/all/cent_com/rep_door,
/obj/machinery/door/firedoor,
/obj/effect/landmark/navigate_destination/autoname,
/obj/effect/turf_decal/siding/wood{
	dir = 1
	},
/obj/effect/mapping_helpers/airlock/unres,
/turf/open/floor/wood,
/area/station/command/heads_quarters/nt_rep)
"aR" = (
/obj/structure/chair/comfy/beige,
/turf/open/floor/wood/large,
/area/station/command/heads_quarters/nt_rep)
"aS" = (
/obj/structure/chair/plastic,
/turf/open/floor/carpet/green,
/area/station/command/heads_quarters/nt_rep)
"aT" = (
/obj/effect/turf_decal/siding/wood{
	dir = 1
	},
/turf/open/floor/wood,
/area/station/command/heads_quarters/nt_rep)
"aU" = (
/obj/machinery/atmospherics/pipe/smart/manifold4w/supply/hidden/layer4,
/turf/open/floor/wood/large,
/area/station/command/heads_quarters/nt_rep)
"aV" = (
/obj/machinery/atmospherics/pipe/smart/manifold4w/supply/hidden/layer4,
/obj/effect/mapping_helpers/airlock/access/all/cent_com/rep_door,
/obj/machinery/door/airlock/maintenance,
/obj/effect/turf_decal/siding/wood{
	dir = 7
	},
/obj/effect/mapping_helpers/airlock/unres{
	dir = 1
	},
/turf/open/floor/wood,
/area/station/maintenance/port)
"aW" = (
/obj/machinery/camera/directional/west{
	c_tag = "NT Consultant's Office";
	name = "command camera"
	},
/obj/structure/cable,
/obj/machinery/power/apc/auto_name/directional/west,
/turf/open/floor/wood/large,
/area/station/command/heads_quarters/nt_rep)
"aX" = (
/turf/open/floor/wood/large,
/area/station/command/heads_quarters/nt_rep)
"aY" = (
/turf/closed/wall/r_wall,
/area/station/command/heads_quarters/nt_rep)
"aZ" = (
/obj/effect/turf_decal/siding/wood{
	dir = 1
	},
/obj/machinery/photocopier/prebuilt,
/turf/open/floor/wood,
/area/station/command/heads_quarters/nt_rep)
"cd" = (
/obj/machinery/atmospherics/pipe/smart/manifold4w/scrubbers/hidden/layer2,
/turf/open/floor/wood/large,
/area/station/command/heads_quarters/nt_rep)
"hZ" = (
/obj/machinery/modular_computer/preset/time_clock/directional/south,
/obj/effect/turf_decal/tile/blue{
	dir = 8
	},
/turf/open/floor/iron,
/area/station/hallway/primary/port)
"mc" = (
/obj/structure/cable,
/obj/machinery/atmospherics/pipe/smart/manifold4w/scrubbers/hidden/layer2,
/turf/open/floor/wood/large,
/area/station/command/heads_quarters/nt_rep)
"mv" = (
/obj/effect/turf_decal/tile/blue{
	dir = 8
	},
/obj/structure/sign/flag/nanotrasen/directional/south,
/turf/open/floor/iron,
/area/template_noop)
"pG" = (
/obj/machinery/door/airlock/corporate{
	name = "NT Consultant's Office"
	},
/obj/structure/cable,
/obj/machinery/atmospherics/pipe/smart/manifold4w/scrubbers/hidden/layer2,
/obj/effect/mapping_helpers/airlock/access/all/cent_com/rep_door,
/obj/machinery/door/firedoor,
/obj/effect/landmark/navigate_destination/autoname,
/obj/effect/mapping_helpers/airlock/unres,
/obj/merge_conflict_marker{
	name = "---Merge Conflict Marker---";
	
	desc = "A best-effort merge was performed. You must resolve this conflict yourself (manually) and remove this object once complete."
	},
/obj/machinery/door/airlock/corporate{
	name = "NT Consultant's Office"
	},
/obj/structure/cable,
/obj/machinery/atmospherics/pipe/smart/manifold4w/scrubbers/hidden/layer2,
/obj/effect/mapping_helpers/airlock/access/all/cent_com/rep_door,
/obj/machinery/door/firedoor,
/obj/effect/landmark/navigate_destination/autoname,
/obj/effect/turf_decal/siding/wood{
	dir = 1
	},
/obj/effect/mapping_helpers/airlock/unres/delayed,
/turf/open/floor/iron/dark/smooth_large,
/area/station/command/heads_quarters/nt_rep)
"qz" = (
/obj/effect/turf_decal/tile/blue{
	dir = 8
	},
/turf/open/floor/iron,
/area/template_noop)
"rM" = (
/obj/machinery/firealarm/directional/east,
/obj/machinery/light/small/blacklight/directional/east{
	desc = "A small lighting fixture. Why is this here?"
	},
/turf/open/floor/wood/large,
/area/station/command/heads_quarters/nt_rep)
"vq" = (
/obj/effect/turf_decal/tile/blue{
	dir = 8
	},
/turf/open/floor/iron,
/area/station/hallway/primary/port)
"xg" = (
/obj/structure/cable,
/obj/machinery/atmospherics/pipe/smart/manifold4w/scrubbers/hidden/layer2,
/obj/machinery/light_switch/directional/east,
/turf/open/floor/wood/large,
/area/station/command/heads_quarters/nt_rep)
"yR" = (
/obj/effect/spawner/structure/window/reinforced,
/obj/machinery/door/poddoor/preopen{
	id = "nt_rep_priv";
	name = "Privacy Shutter"
	},
/obj/machinery/door/poddoor/shutters/preopen{
	id = "nt_rep_priv";
	name = "Privacy Shutters";
	dir = 1
	},
/turf/open/floor/plating,
/area/station/command/heads_quarters/nt_rep)
"NE" = (
/obj/structure/closet/secure_closet/nanotrasen_consultant,
/turf/open/floor/wood/large,
/area/station/command/heads_quarters/nt_rep)
"NS" = (
/obj/structure/table/wood,
/obj/item/statuebust/hippocratic{
	pixel_y = 8
	},
/turf/open/floor/wood/large,
/area/station/command/heads_quarters/nt_rep)
"Qc" = (
/obj/machinery/atmospherics/components/unary/vent_scrubber/on/layer2{
	dir = 4
	},
/obj/machinery/light/directional/west,
/turf/open/floor/wood/large,
/area/station/command/heads_quarters/nt_rep)
"VO" = (
/obj/structure/table/wood,
/obj/item/table_clock{
	pixel_y = 5
	},
/obj/machinery/button/door/directional/west{
	name = "Privacy Shutters Control";
	id = "nt_rep_priv";
	req_access = list("cent_general")
	},
/turf/open/floor/wood/large,
/area/station/command/heads_quarters/nt_rep)
"XN" = (
/obj/structure/cable,
/turf/open/floor/wood/large,
/area/station/command/heads_quarters/nt_rep)

(1,1,1) = {"
mv
ad
ad
ad
ad
ad
ad
ad
ad
"}
(2,1,1) = {"
vq
yR
VO
Qc
aW
aJ
aI
ax
ad
"}
(3,1,1) = {"
vq
yR
NS
cd
XN
aR
ao
aj
ad
"}
(4,1,1) = {"
qz
pG
xg
mc
XN
ac
ae
aO
ad
"}
(5,1,1) = {"
hZ
aY
aY
aX
aX
aX
aX
aU
aG
"}
(6,1,1) = {"
aD
aD
aY
aX
aX
am
aX
at
ad
"}
(7,1,1) = {"
aD
aD
aY
NE
rM
aX
aK
ar
ad
"}
(8,1,1) = {"
aD
aq
aY
aY
ad
ad
ad
ad
ad
"}
