//MAP CONVERTED BY dmm2tgm.py THIS HEADER COMMENT PREVENTS RECONVERSION, DO NOT REMOVE
"ap" = (
/obj/effect/turf_decal/siding/wood,
/obj/structure/chair/wood,
/turf/open/floor/wood/large,
/area/station/command/heads_quarters/nt_rep)
"cd" = (
/obj/machinery/duct,
/turf/closed/wall/r_wall,
/area/station/command/heads_quarters/nt_rep)
"cx" = (
/obj/structure/table,
/obj/machinery/microwave{
	pixel_x = -1;
	pixel_y = 5
	},
/obj/machinery/duct,
/turf/open/floor/iron/cafeteria,
/area/station/command/heads_quarters/nt_rep)
"cB" = (
/obj/structure/sign/picture_frame/showroom/four{
	pixel_y = 32
	},
/obj/machinery/airalarm/directional/east,
/obj/machinery/atmospherics/pipe/smart/manifold4w/scrubbers/hidden/layer2,
/obj/machinery/atmospherics/pipe/smart/manifold4w/supply/hidden/layer4,
/obj/structure/disposalpipe/segment{
	dir = 10
	},
/obj/effect/turf_decal/siding/wood{
	dir = 5
	},
/obj/item/statuebust{
	pixel_y = 10
	},
/obj/structure/table/wood/fancy/royalblue,
/turf/open/floor/wood/large,
/area/station/command/heads_quarters/nt_rep)
"cY" = (
/obj/structure/bed/double,
/obj/machinery/light_switch/directional/south,
/obj/item/bedsheet/nanotrasen/double,
/turf/open/floor/carpet/blue,
/area/station/command/heads_quarters/nt_rep)
"du" = (
/obj/item/radio/intercom/directional/west,
/obj/machinery/light/directional/west,
/obj/machinery/atmospherics/components/unary/vent_pump/on/layer4{
	dir = 4
	},
/obj/effect/turf_decal/siding/wood{
	dir = 8
	},
/obj/structure/chair/comfy/brown{
	dir = 1
	},
/turf/open/floor/wood/parquet,
/area/station/command/heads_quarters/nt_rep)
"ef" = (
/obj/structure/closet/secure_closet/freezer/fridge/all_access,
/obj/item/storage/box/ingredients/vegetarian,
/obj/item/storage/box/ingredients/italian,
/obj/item/storage/box/ingredients/fruity,
/obj/item/storage/box/ingredients/fiesta,
/obj/item/storage/box/ingredients/american,
/obj/item/reagent_containers/condiment/flour{
	list_reagents = list(/datum/reagent/consumable/flour=600);
	name = "Premium All-Purpose Flour (16KG)";
	volume = 600
	},
/obj/item/reagent_containers/condiment/milk,
/obj/item/reagent_containers/condiment/enzyme{
	list_reagents = list(/datum/reagent/consumable/enzyme=500);
	name = "universe-sized universal enyzyme";
	volume = 500
	},
/obj/item/reagent_containers/condiment/rice{
	list_reagents = list(/datum/reagent/consumable/rice=150);
	name = "Basmati Rice Sack (4KG)";
	volume = 150
	},
/obj/item/food/meat/slab,
/obj/item/food/meat/slab,
/obj/item/food/meat/slab,
/obj/item/food/meat/rawbacon,
/obj/item/food/meat/rawbacon,
/obj/item/food/meat/rawbacon,
/obj/item/food/meat/slab/chicken,
/obj/item/food/meat/slab/chicken,
/obj/item/food/meat/slab/chicken,
/turf/open/floor/iron/cafeteria,
/area/station/command/heads_quarters/nt_rep)
"gc" = (
/obj/structure/flora/grass/jungle,
/obj/structure/flora/bush/grassy,
/obj/structure/flora/bush/flowers_yw,
/obj/structure/window/reinforced/spawner/directional/east,
/obj/structure/window/reinforced/spawner/directional/west,
/obj/structure/curtain/cloth/fancy/mechanical{
	icon_state = "bounty-open";
	icon_type = "bounty";
	id = "prisonlibrarycurtain3";
	name = "curtain"
	},
/turf/open/floor/grass,
/area/station/command/heads_quarters/nt_rep)
"gr" = (
/obj/structure/sign/painting/parting{
	pixel_y = 32
	},
/obj/structure/grandfatherclock,
/obj/machinery/light_switch/directional/west,
/obj/effect/turf_decal/siding/wood{
	dir = 9
	},
/turf/open/floor/wood/large,
/area/station/command/heads_quarters/nt_rep)
"hb" = (
/obj/effect/landmark/start/nanotrasen_consultant,
/obj/structure/disposalpipe/segment,
/obj/structure/chair/comfy/brown{
	dir = 1
	},
/turf/open/floor/carpet/executive,
/area/station/command/heads_quarters/nt_rep)
"hP" = (
/obj/machinery/shower/directional/west,
/obj/structure/drain,
/obj/machinery/light/small/directional/south,
/turf/open/floor/iron/freezer,
/area/station/command/heads_quarters/nt_rep)
"iB" = (
/obj/structure/table/reinforced/titaniumglass,
/obj/machinery/fax{
	fax_name = "Nanotrasen Consultant's Office";
	name = "Nanotrasen Consultant's Fax Machine"
	},
/turf/open/floor/carpet/executive,
/area/station/command/heads_quarters/nt_rep)
"jm" = (
/obj/structure/cable,
/obj/machinery/atmospherics/pipe/smart/manifold4w/supply/hidden/layer4,
/obj/machinery/atmospherics/pipe/smart/manifold4w/scrubbers/hidden/layer2,
/obj/structure/disposalpipe/segment{
	dir = 5
	},
/obj/effect/turf_decal/siding/wood{
	dir = 4
	},
/turf/open/floor/wood/large,
/area/station/command/heads_quarters/nt_rep)
"jN" = (
/obj/effect/landmark/start/nanotrasen_consultant,
/obj/machinery/camera/directional/west{
	c_tag = "Command - Representative's Quarters";
	name = "command camera"
	},
/obj/machinery/firealarm/directional/west,
/obj/structure/chair/sofa/right/brown{
	dir = 4;
	color = "#462f1c"
	},
/turf/open/floor/carpet/royalblue,
/area/station/command/heads_quarters/nt_rep)
"jT" = (
/obj/machinery/atmospherics/pipe/smart/manifold4w/scrubbers/hidden/layer2,
/obj/machinery/atmospherics/pipe/smart/manifold4w/supply/hidden/layer4,
/obj/machinery/door/airlock/corporate{
	name = "Nanotrasen Internal Affairs Quarters"
	},
/obj/effect/mapping_helpers/airlock/access/all/cent_com/rep_door,
/turf/open/floor/iron/dark/smooth_large,
/area/station/command/heads_quarters/nt_rep)
"kl" = (
/obj/effect/landmark/start/nanotrasen_consultant,
/obj/structure/chair/sofa/left/brown{
	dir = 4;
	color = "#462f1c"
	},
/obj/structure/sign/poster/official/nanotrasen_logo/directional/west,
/turf/open/floor/carpet/royalblue,
/area/station/command/heads_quarters/nt_rep)
"kQ" = (
/obj/machinery/atmospherics/components/unary/vent_scrubber/on/layer2{
	dir = 1
	},
/obj/machinery/digital_clock/directional/south,
/mob/living/basic/drone/snowflake/bardrone{
	ghost_controllable = 1
	},
/obj/effect/turf_decal/siding/wood{
	dir = 6
	},
/turf/open/floor/wood/large,
/area/station/command/heads_quarters/nt_rep)
"lb" = (
/obj/structure/bookcase/random,
/obj/effect/turf_decal/siding/wood{
	dir = 10
	},
/turf/open/floor/wood/parquet,
/area/station/command/heads_quarters/nt_rep)
"mg" = (
/obj/machinery/light/directional/south,
/obj/effect/turf_decal/siding/wood,
/obj/structure/table/wood,
/obj/item/clipboard{
	pixel_y = 3;
	pixel_x = 2
	},
/obj/item/folder/yellow{
	pixel_y = 1;
	pixel_x = -2
	},
/obj/machinery/status_display/evac/directional/south,
/turf/open/floor/wood/large,
/area/station/command/heads_quarters/nt_rep)
"nk" = (
/obj/structure/chair/office,
/obj/effect/landmark/start/nanotrasen_crew_trainer,
/turf/open/floor/wood/large,
/area/station/command/heads_quarters/nt_rep)
"nm" = (
/obj/structure/table/reinforced/titaniumglass,
/obj/item/paper_bin{
	pixel_y = 5;
	pixel_x = -4
	},
/obj/item/stamp{
	pixel_y = 12;
	pixel_x = 8
	},
/obj/item/stamp/denied{
	pixel_x = 8;
	pixel_y = 6
	},
/obj/item/stamp/nanotrasen{
	pixel_x = 8
	},
/obj/item/pen/fountain/nanotrasen{
	pixel_y = 5;
	pixel_x = -4
	},
/turf/open/floor/carpet/executive,
/area/station/command/heads_quarters/nt_rep)
"nx" = (
/obj/structure/table,
/obj/machinery/reagentgrinder{
	pixel_x = -6;
	pixel_y = 10
	},
/obj/item/knife{
	pixel_x = 6;
	pixel_y = 7
	},
/obj/item/kitchen/rollingpin,
/obj/machinery/light/directional/south,
/obj/machinery/atmospherics/components/unary/vent_scrubber/on/layer2{
	dir = 1
	},
/obj/machinery/duct,
/turf/open/floor/iron/cafeteria,
/area/station/command/heads_quarters/nt_rep)
"oV" = (
/turf/open/floor/wood/large,
/area/station/command/heads_quarters/nt_rep)
"pT" = (
/obj/machinery/light/directional/east,
/obj/structure/chair/sofa/right/brown{
	dir = 8;
	color = "#462f1c"
	},
/obj/effect/landmark/start/nanotrasen_crew_trainer,
/turf/open/floor/carpet/royalblue,
/area/station/command/heads_quarters/nt_rep)
"pW" = (
/turf/closed/wall,
/area/station/command/heads_quarters/nt_rep)
"rB" = (
/obj/structure/table/wood,
/obj/item/reagent_containers/cup/glass/mug/coco{
	desc = "Still hot!";
	pixel_x = -4;
	pixel_y = 4
	},
/obj/item/reagent_containers/cup/glass/shaker{
	pixel_x = 7;
	pixel_y = 10
	},
/turf/open/floor/carpet/royalblue,
/area/station/command/heads_quarters/nt_rep)
"sl" = (
/obj/structure/disposalpipe/segment{
	dir = 4
	},
/obj/machinery/computer/station_goal{
	dir = 1
	},
/obj/machinery/keycard_auth/wall_mounted/directional/south,
/turf/open/floor/carpet/executive,
/area/station/command/heads_quarters/nt_rep)
"ss" = (
/obj/machinery/light/directional/west,
/obj/structure/aquarium/prefilled,
/obj/structure/sign/clock/directional/west,
/obj/item/reagent_containers/cup/fish_feed{
	pixel_y = 17;
	pixel_x = -3
	},
/turf/open/floor/carpet/executive,
/area/station/command/heads_quarters/nt_rep)
"sC" = (
/obj/machinery/door/firedoor,
/obj/structure/cable,
/obj/machinery/atmospherics/pipe/smart/manifold4w/scrubbers/hidden/layer2,
/obj/machinery/atmospherics/pipe/smart/manifold4w/supply/hidden/layer4,
/obj/structure/disposalpipe/segment,
/obj/effect/mapping_helpers/airlock/access/all/cent_com/rep_door,
/obj/machinery/door/airlock/corporate{
	name = "Nanotrasen Internal Affairs Office"
	},
/obj/effect/mapping_helpers/airlock/unres,
/obj/effect/landmark/navigate_destination/autoname,
/turf/open/floor/iron/dark/smooth_large,
/area/station/command/heads_quarters/nt_rep)
"sD" = (
/obj/structure/window/spawner/directional/west,
/obj/structure/sign/clock/directional/north,
/obj/structure/dresser,
/turf/open/floor/carpet/blue,
/area/station/command/heads_quarters/nt_rep)
"tb" = (
/obj/machinery/atmospherics/pipe/smart/manifold4w/scrubbers/hidden/layer2,
/obj/machinery/atmospherics/pipe/smart/manifold4w/supply/hidden/layer4,
/obj/effect/turf_decal/siding/wood,
/turf/open/floor/wood/large,
/area/station/command/heads_quarters/nt_rep)
"tj" = (
/obj/structure/table/reinforced/titaniumglass,
/obj/item/flashlight/lamp/green{
	pixel_y = 13;
	pixel_x = -6
	},
/obj/item/coin/gold{
	pixel_x = -7;
	pixel_y = -3
	},
/obj/machinery/recharger{
	pixel_y = 3;
	pixel_x = 7
	},
/turf/open/floor/carpet/executive,
/area/station/command/heads_quarters/nt_rep)
"tv" = (
/obj/item/flashlight/lamp/green{
	pixel_x = 5;
	pixel_y = 16
	},
/obj/item/paper_bin{
	pixel_y = 3
	},
/obj/item/pen/fountain{
	pixel_y = 5
	},
/obj/structure/table/wood/fancy/blue,
/obj/effect/turf_decal/siding/wood{
	dir = 5
	},
/turf/open/floor/wood/parquet,
/area/station/command/heads_quarters/nt_rep)
"tw" = (
/turf/template_noop,
/area/template_noop)
"tE" = (
/obj/effect/turf_decal/siding/wood{
	dir = 10
	},
/obj/structure/table/wood,
/obj/item/paper_bin{
	pixel_y = 5;
	pixel_x = -4
	},
/obj/item/stamp{
	pixel_y = 9;
	pixel_x = 8
	},
/obj/item/stamp/denied{
	pixel_x = 8;
	pixel_y = 2
	},
/obj/machinery/newscaster/directional/south,
/obj/structure/sign/poster/official/nanotrasen_logo/directional/west,
/turf/open/floor/wood/large,
/area/station/command/heads_quarters/nt_rep)
"tI" = (
/obj/structure/cable,
/obj/machinery/atmospherics/pipe/smart/manifold4w/supply/hidden/layer4,
/obj/machinery/atmospherics/pipe/smart/manifold4w/scrubbers/hidden/layer2,
/obj/structure/disposalpipe/segment{
	dir = 4
	},
/obj/effect/turf_decal/siding/wood,
/obj/structure/chair/wood,
/turf/open/floor/wood/large,
/area/station/command/heads_quarters/nt_rep)
"tO" = (
/obj/structure/filingcabinet/medical{
	pixel_x = -10;
	icon_state = "employmentcabinet";
	name = "medical records filing cabinet"
	},
/obj/structure/filingcabinet/employment{
	name = "employment forms filing cabinet"
	},
/obj/structure/filingcabinet/security{
	pixel_x = 10;
	icon_state = "employmentcabinet";
	name = "security records filing cabinet"
	},
/obj/machinery/requests_console/directional/south,
/obj/effect/mapping_helpers/requests_console/assistance,
/obj/effect/mapping_helpers/requests_console/information,
/obj/effect/mapping_helpers/requests_console/announcement,
/turf/open/floor/carpet/executive,
/area/station/command/heads_quarters/nt_rep)
"tV" = (
/obj/structure/sink/kitchen/directional/west,
/obj/machinery/atmospherics/components/unary/vent_pump/on/layer4{
	dir = 8
	},
/turf/open/floor/iron/cafeteria,
/area/station/command/heads_quarters/nt_rep)
"ua" = (
/obj/machinery/disposal/bin,
/obj/machinery/light/directional/west,
/obj/structure/disposalpipe/trunk{
	dir = 4
	},
/obj/effect/turf_decal/siding/wood{
	dir = 9
	},
/turf/open/floor/wood/large,
/area/station/command/heads_quarters/nt_rep)
"uQ" = (
/obj/structure/cable,
/obj/machinery/atmospherics/pipe/smart/manifold4w/supply/hidden/layer4,
/obj/machinery/atmospherics/pipe/smart/manifold4w/scrubbers/hidden/layer2,
/obj/structure/disposalpipe/segment{
	dir = 4
	},
/obj/effect/turf_decal/siding/wood{
	dir = 10
	},
/turf/open/floor/wood/large,
/area/station/command/heads_quarters/nt_rep)
"uT" = (
/obj/machinery/disposal/bin,
/obj/machinery/light/directional/east,
/obj/structure/disposalpipe/trunk{
	dir = 8
	},
/obj/structure/sign/calendar/directional/south,
/obj/structure/noticeboard/directional/west{
	name = "Nanotrasen Consultant's Notice Board";
	pixel_x = 32
	},
/turf/open/floor/carpet/executive,
/area/station/command/heads_quarters/nt_rep)
"vo" = (
/obj/structure/cable,
/obj/machinery/atmospherics/pipe/smart/manifold4w/scrubbers/hidden/layer2,
/obj/machinery/atmospherics/pipe/smart/manifold4w/supply/hidden/layer4,
/obj/structure/disposalpipe/segment,
/obj/effect/turf_decal/siding/wood{
	dir = 1
	},
/obj/effect/landmark/start/nanotrasen_crew_trainer,
/turf/open/floor/wood/large,
/area/station/command/heads_quarters/nt_rep)
"vu" = (
/obj/machinery/atmospherics/pipe/smart/manifold4w/supply/hidden/layer4,
/obj/machinery/atmospherics/pipe/smart/manifold4w/scrubbers/hidden/layer2,
/obj/structure/disposalpipe/segment{
	dir = 9
	},
/obj/effect/turf_decal/siding/wood{
	dir = 8
	},
/turf/open/floor/wood/large,
/area/station/command/heads_quarters/nt_rep)
"vW" = (
/obj/structure/window/spawner/directional/west,
/turf/open/floor/carpet/blue,
/area/station/command/heads_quarters/nt_rep)
"wj" = (
/obj/item/reagent_containers/cup/glass/bottle/whiskey{
	pixel_x = 10;
	pixel_y = 16
	},
/obj/item/reagent_containers/cup/glass/drinkingglass/shotglass{
	pixel_x = 11;
	pixel_y = 4
	},
/obj/item/reagent_containers/cup/glass/drinkingglass/shotglass{
	pixel_x = 2;
	pixel_y = 6
	},
/obj/structure/table/reinforced/titaniumglass,
/obj/item/phone{
	pixel_x = -5;
	pixel_y = 10
	},
/obj/item/cigarette/pipe{
	pixel_x = -5
	},
/turf/open/floor/carpet/executive,
/area/station/command/heads_quarters/nt_rep)
"wn" = (
/obj/machinery/door/airlock/corporate{
	name = "Consultant's Desk"
	},
/obj/effect/mapping_helpers/airlock/access/all/cent_com/rep_door,
/turf/open/floor/iron/dark/smooth_large,
/area/station/command/heads_quarters/nt_rep)
"xk" = (
/obj/structure/plaque/static_plaque/golden{
	pixel_y = 32
	},
/turf/template_noop,
/area/template_noop)
"ya" = (
/obj/structure/plaque/static_plaque/golden/captain{
	pixel_y = -32
	},
/obj/machinery/modular_computer/preset/command{
	dir = 1
	},
/obj/machinery/camera/directional/south{
	c_tag = "Command - Representative's Office";
	name = "command camera"
	},
/obj/structure/disposalpipe/segment{
	dir = 5
	},
/turf/open/floor/carpet/executive,
/area/station/command/heads_quarters/nt_rep)
"yr" = (
/obj/machinery/chem_dispenser/drinks{
	pixel_y = -3
	},
/turf/closed/wall/r_wall,
/area/station/command/heads_quarters/nt_rep)
"zg" = (
/obj/effect/turf_decal/siding/wood,
/obj/machinery/door/airlock/bathroom{
	name = "Restroom"
	},
/turf/open/floor/iron/freezer,
/area/station/command/heads_quarters/nt_rep)
"zN" = (
/obj/structure/table/reinforced,
/obj/machinery/door/firedoor,
/obj/item/kitchen/fork{
	pixel_x = -12;
	pixel_y = 2
	},
/obj/item/kitchen/spoon{
	pixel_x = 10;
	pixel_y = 2
	},
/obj/item/kitchen/fork{
	pixel_x = -12;
	pixel_y = 2
	},
/obj/item/kitchen/fork{
	pixel_x = -12;
	pixel_y = 2
	},
/obj/item/kitchen/fork{
	pixel_x = -12;
	pixel_y = 2
	},
/obj/item/kitchen/spoon{
	pixel_x = 10;
	pixel_y = 2
	},
/obj/item/kitchen/spoon{
	pixel_x = 10;
	pixel_y = 2
	},
/obj/item/kitchen/spoon{
	pixel_x = 10;
	pixel_y = 2
	},
/obj/item/plate,
/obj/item/plate{
	pixel_y = 2
	},
/obj/item/plate{
	pixel_y = 4
	},
/obj/item/plate{
	pixel_y = 6
	},
/obj/machinery/door/window/right/directional/south{
	name = "Kitchen Counter"
	},
/turf/open/floor/iron/dark/smooth_large,
/area/station/command/heads_quarters/nt_rep)
"Bu" = (
/obj/structure/sign/directions/vault{
	dir = 8;
	pixel_y = 6
	},
/obj/structure/sign/directions/upload{
	dir = 4
	},
/turf/closed/wall/r_wall,
/area/station/command/heads_quarters/nt_rep)
"BM" = (
/obj/structure/cable,
/obj/machinery/atmospherics/pipe/smart/manifold4w/scrubbers/hidden/layer2,
/obj/machinery/atmospherics/pipe/smart/manifold4w/supply/hidden/layer4,
/obj/structure/disposalpipe/junction/flip{
	dir = 1
	},
/obj/machinery/holopad/secure,
/obj/effect/turf_decal/siding/wood,
/turf/open/floor/wood/large,
/area/station/command/heads_quarters/nt_rep)
"Co" = (
/obj/machinery/atmospherics/pipe/smart/manifold4w/scrubbers/hidden/layer2,
/obj/machinery/atmospherics/pipe/smart/manifold4w/supply/hidden/layer4,
/obj/structure/disposalpipe/segment{
	dir = 4
	},
/obj/effect/turf_decal/siding/wood{
	dir = 5
	},
/turf/open/floor/wood/large,
/area/station/command/heads_quarters/nt_rep)
"CR" = (
/obj/machinery/atmospherics/components/unary/vent_scrubber/on/layer2{
	dir = 1
	},
/obj/effect/turf_decal/siding/wood{
	dir = 6
	},
/turf/open/floor/wood/parquet,
/area/station/command/heads_quarters/nt_rep)
"Dq" = (
/obj/machinery/atmospherics/pipe/smart/manifold4w/scrubbers/hidden/layer2,
/obj/machinery/atmospherics/pipe/smart/manifold4w/supply/hidden/layer4,
/turf/open/floor/carpet/blue,
/area/station/command/heads_quarters/nt_rep)
"DE" = (
/turf/open/floor/carpet/executive,
/area/station/command/heads_quarters/nt_rep)
"Fj" = (
/obj/effect/spawner/structure/window/reinforced,
/obj/structure/cable,
/obj/structure/curtain/cloth/fancy/mechanical{
	icon_state = "bounty-open";
	icon_type = "bounty";
	id = "prisonlibrarycurtain3";
	name = "curtain"
	},
/turf/open/floor/plating,
/area/station/command/heads_quarters/nt_rep)
"FO" = (
/obj/machinery/atmospherics/pipe/smart/manifold4w/supply/hidden/layer4,
/obj/machinery/duct,
/turf/open/floor/iron/cafeteria,
/area/station/command/heads_quarters/nt_rep)
"FS" = (
/obj/machinery/vending/boozeomat,
/turf/closed/wall/r_wall,
/area/station/command/heads_quarters/nt_rep)
"FY" = (
/obj/structure/extinguisher_cabinet/directional/north,
/obj/machinery/light/directional/north,
/obj/machinery/atmospherics/pipe/smart/manifold4w/scrubbers/hidden/layer2,
/obj/machinery/atmospherics/pipe/smart/manifold4w/supply/hidden/layer4,
/obj/structure/disposalpipe/segment{
	dir = 4
	},
/obj/effect/turf_decal/siding/wood{
	dir = 1
	},
/obj/item/statuebust/hippocratic{
	pixel_y = 10
	},
/obj/structure/table/wood/fancy/royalblue,
/turf/open/floor/wood/large,
/area/station/command/heads_quarters/nt_rep)
"JA" = (
/obj/structure/toilet{
	pixel_y = 16
	},
/obj/structure/sink/directional/east,
/obj/structure/mirror/directional/west,
/turf/open/floor/iron/freezer,
/area/station/command/heads_quarters/nt_rep)
"JM" = (
/obj/machinery/atmospherics/components/unary/vent_pump/on/layer4{
	dir = 8
	},
/obj/effect/turf_decal/siding/wood{
	dir = 1
	},
/obj/structure/bed/dogbed/ian{
	name = "Lisa's bed";
	desc = "Lisa's bed! Looks comfy."
	},
/mob/living/basic/pet/dog/corgi/lisa,
/turf/open/floor/wood/large,
/area/station/command/heads_quarters/nt_rep)
"Ke" = (
/obj/structure/flora/grass/jungle,
/obj/structure/flora/bush/grassy,
/obj/structure/flora/bush/sunny,
/obj/structure/flora/bush/flowers_pp,
/obj/structure/window/reinforced/spawner/directional/east,
/obj/structure/window/reinforced/spawner/directional/west,
/obj/structure/curtain/cloth/fancy/mechanical{
	icon_state = "bounty-open";
	icon_type = "bounty";
	id = "prisonlibrarycurtain3";
	name = "curtain"
	},
/turf/open/floor/grass,
/area/station/command/heads_quarters/nt_rep)
"Kp" = (
/obj/machinery/atmospherics/components/unary/vent_pump/on/layer4{
	dir = 4
	},
/obj/structure/disposalpipe/segment{
	dir = 4
	},
/obj/effect/turf_decal/siding/wood{
	dir = 1
	},
/turf/open/floor/wood/large,
/area/station/command/heads_quarters/nt_rep)
"KH" = (
/obj/machinery/atmospherics/pipe/smart/manifold4w/supply/hidden/layer4,
/obj/machinery/atmospherics/pipe/smart/manifold4w/scrubbers/hidden/layer2,
/obj/structure/disposalpipe/segment{
	dir = 4
	},
/obj/effect/mapping_helpers/airlock/access/all/cent_com/rep_door,
/obj/machinery/door/airlock/corporate{
	name = "Nanotrasen Internal Affairs Lounge"
	},
/turf/open/floor/iron/dark/smooth_large,
/area/station/command/heads_quarters/nt_rep)
"KM" = (
/turf/closed/wall/r_wall,
/area/station/command/heads_quarters/nt_rep)
"Lb" = (
/obj/machinery/griddle,
/obj/item/radio/intercom/directional/south,
/obj/machinery/duct,
/turf/open/floor/iron/cafeteria,
/area/station/command/heads_quarters/nt_rep)
"LK" = (
/obj/effect/turf_decal/siding/wood{
	dir = 6
	},
/obj/structure/table/wood,
/obj/item/table_clock{
	pixel_y = 5
	},
/obj/item/radio/intercom/directional/south,
/turf/open/floor/wood/large,
/area/station/command/heads_quarters/nt_rep)
"Mk" = (
/obj/structure/displaycase/trophy,
/obj/machinery/light/directional/east,
/obj/machinery/firealarm/directional/north,
/obj/effect/turf_decal/siding/wood{
	dir = 5
	},
/obj/machinery/newscaster/directional/east,
/turf/open/floor/wood/large,
/area/station/command/heads_quarters/nt_rep)
"MB" = (
/obj/machinery/atmospherics/pipe/smart/manifold4w/scrubbers/hidden/layer2,
/obj/machinery/atmospherics/pipe/smart/manifold4w/supply/hidden/layer4,
/turf/open/floor/iron/cafeteria,
/area/station/command/heads_quarters/nt_rep)
"MR" = (
/obj/structure/table/wood,
/obj/item/kirbyplants/organic/plant17{
	pixel_y = 26
	},
/obj/item/newspaper{
	pixel_x = 4;
	pixel_y = 4
	},
/obj/item/reagent_containers/condiment/peppermill{
	pixel_x = 3
	},
/obj/item/reagent_containers/condiment/saltshaker{
	pixel_x = -3
	},
/turf/open/floor/carpet/royalblue,
/area/station/command/heads_quarters/nt_rep)
"Ne" = (
/obj/machinery/atmospherics/pipe/smart/manifold4w/scrubbers/hidden/layer2,
/obj/machinery/atmospherics/pipe/smart/manifold4w/supply/hidden/layer4,
/obj/structure/disposalpipe/segment{
	dir = 4
	},
/obj/effect/turf_decal/siding/wood{
	dir = 1
	},
/turf/open/floor/wood/large,
/area/station/command/heads_quarters/nt_rep)
"Ng" = (
/obj/machinery/atmospherics/pipe/smart/manifold4w/scrubbers/hidden/layer2,
/obj/machinery/atmospherics/pipe/smart/manifold4w/supply/hidden/layer4,
/obj/machinery/door/airlock/corporate/glass{
	name = "Nanotrasen Internal Affairs Kitchen"
	},
/turf/open/floor/iron/dark/smooth_large,
/area/station/command/heads_quarters/nt_rep)
"NH" = (
/obj/effect/spawner/structure/window/reinforced,
/obj/structure/curtain/bounty,
/turf/open/floor/plating,
/area/station/command/heads_quarters/nt_rep)
"NN" = (
/obj/structure/cable,
/obj/machinery/atmospherics/pipe/smart/manifold4w/supply/hidden/layer4,
/obj/machinery/atmospherics/pipe/smart/manifold4w/scrubbers/hidden/layer2,
/obj/structure/disposalpipe/segment{
	dir = 4
	},
/obj/effect/mapping_helpers/airlock/access/all/cent_com/rep_door,
/obj/machinery/door/airlock/corporate{
	name = "Nanotrasen Internal Affairs Office"
	},
/turf/open/floor/iron/dark/smooth_large,
/area/station/command/heads_quarters/nt_rep)
"OF" = (
/obj/machinery/atmospherics/components/unary/vent_pump/on/layer4{
	dir = 1
	},
/obj/effect/turf_decal/siding/wood{
	dir = 8
	},
/obj/structure/closet/secure_closet/nanotrasen_crew_trainer,
/obj/item/storage/lunchbox/nanotrasen,
/turf/open/floor/wood/large,
/area/station/command/heads_quarters/nt_rep)
"Px" = (
/obj/machinery/power/apc/auto_name/directional/east,
/obj/structure/cable,
/obj/machinery/atmospherics/components/unary/vent_scrubber/on/layer2{
	dir = 1
	},
/obj/effect/turf_decal/siding/wood{
	dir = 4
	},
/turf/open/floor/wood/large,
/area/station/command/heads_quarters/nt_rep)
"QQ" = (
/obj/machinery/oven/range,
/obj/machinery/firealarm/directional/west,
/turf/open/floor/iron/cafeteria,
/area/station/command/heads_quarters/nt_rep)
"RW" = (
/obj/machinery/status_display/evac/directional/south,
/obj/structure/secure_safe/directional/west,
/obj/structure/closet/secure_closet/nanotrasen_consultant,
/obj/item/clothing/accessory/medal/gold/nanotrasen_consultant,
/obj/item/clothing/accessory/medal/gold/ordom,
/obj/item/clothing/accessory/medal/silver/bureaucracy,
/turf/open/floor/carpet/executive,
/area/station/command/heads_quarters/nt_rep)
"RY" = (
/obj/structure/flora/grass/jungle,
/obj/structure/flora/bush/grassy,
/obj/structure/flora/bush/flowers_br,
/obj/structure/window/reinforced/spawner/directional/east,
/obj/structure/window/reinforced/spawner/directional/west,
/obj/structure/curtain/cloth/fancy/mechanical{
	icon_state = "bounty-open";
	icon_type = "bounty";
	id = "prisonlibrarycurtain3";
	name = "curtain"
	},
/turf/open/floor/grass,
/area/station/command/heads_quarters/nt_rep)
"Tu" = (
/obj/item/modular_computer/laptop/preset/civilian{
	pixel_y = 7
	},
/obj/machinery/computer/security/telescreen/entertainment/directional/north,
/obj/structure/table/wood/fancy/blue,
/obj/effect/turf_decal/siding/wood{
	dir = 9
	},
/turf/open/floor/wood/parquet,
/area/station/command/heads_quarters/nt_rep)
"Tv" = (
/obj/machinery/atmospherics/pipe/smart/manifold4w/scrubbers/hidden/layer2,
/obj/machinery/atmospherics/pipe/smart/manifold4w/supply/hidden/layer4,
/obj/effect/turf_decal/siding/wood{
	dir = 4
	},
/turf/open/floor/wood/parquet,
/area/station/command/heads_quarters/nt_rep)
"Ty" = (
/obj/structure/sign/picture_frame/showroom/four{
	pixel_y = 32
	},
/obj/machinery/atmospherics/pipe/smart/manifold4w/scrubbers/hidden/layer2,
/obj/machinery/atmospherics/pipe/smart/manifold4w/supply/hidden/layer4,
/obj/structure/disposalpipe/segment{
	dir = 6
	},
/obj/item/radio/intercom/directional/west,
/obj/effect/turf_decal/siding/wood{
	dir = 9
	},
/obj/structure/statue/bronze/marx{
	pixel_y = 11
	},
/obj/structure/table/wood/fancy/royalblue,
/turf/open/floor/wood/large,
/area/station/command/heads_quarters/nt_rep)
"TY" = (
/obj/machinery/atmospherics/components/unary/vent_scrubber/on/layer2{
	dir = 4
	},
/obj/effect/turf_decal/siding/wood{
	dir = 1
	},
/turf/open/floor/wood/large,
/area/station/command/heads_quarters/nt_rep)
"Uv" = (
/obj/structure/disposalpipe/segment,
/obj/structure/table/reinforced/titaniumglass,
/obj/item/clipboard{
	pixel_y = 3;
	pixel_x = -5
	},
/obj/item/folder/blue{
	pixel_y = 2;
	pixel_x = -4
	},
/obj/item/reagent_containers/cup/glass/mug/nanotrasen{
	pixel_y = 11;
	pixel_x = 11
	},
/obj/item/sign/flag/nanotrasen{
	pixel_x = 5
	},
/turf/open/floor/carpet/executive,
/area/station/command/heads_quarters/nt_rep)
"Vf" = (
/obj/structure/closet/secure_closet/personal/cabinet,
/turf/open/floor/carpet/blue,
/area/station/command/heads_quarters/nt_rep)
"Vr" = (
/obj/structure/chair/sofa/left/brown{
	dir = 8;
	color = "#462f1c"
	},
/obj/effect/landmark/start/nanotrasen_crew_trainer,
/turf/open/floor/carpet/royalblue,
/area/station/command/heads_quarters/nt_rep)
"VI" = (
/obj/effect/turf_decal/siding/wood{
	dir = 4
	},
/turf/open/floor/wood/large,
/area/station/command/heads_quarters/nt_rep)
"VJ" = (
/obj/effect/turf_decal/siding/wood{
	dir = 6
	},
/obj/structure/hedge,
/turf/open/floor/wood/large,
/area/station/command/heads_quarters/nt_rep)
"Xp" = (
/obj/machinery/atmospherics/pipe/smart/manifold4w/scrubbers/hidden/layer2,
/obj/machinery/atmospherics/pipe/smart/manifold4w/supply/hidden/layer4,
/obj/structure/disposalpipe/segment,
/obj/effect/turf_decal/siding/wood{
	dir = 8
	},
/obj/machinery/photocopier/prebuilt,
/obj/item/toy/plush/skyrat/ian/lisa{
	pixel_y = 11
	},
/turf/open/floor/wood/large,
/area/station/command/heads_quarters/nt_rep)
"Zc" = (
/obj/machinery/chem_dispenser/drinks/beer{
	pixel_y = -3
	},
/turf/closed/wall/r_wall,
/area/station/command/heads_quarters/nt_rep)
"Zl" = (
/obj/machinery/atmospherics/pipe/smart/manifold4w/scrubbers/hidden/layer2,
/obj/machinery/atmospherics/pipe/smart/manifold4w/supply/hidden/layer4,
/obj/item/radio/intercom/directional/south,
/obj/effect/turf_decal/siding/wood{
	dir = 10
	},
/turf/open/floor/wood/large,
/area/station/command/heads_quarters/nt_rep)

(1,1,1) = {"
tw
tw
KM
KM
KM
KM
KM
KM
KM
"}
(2,1,1) = {"
tw
tw
KM
Tu
du
lb
pW
JA
KM
"}
(3,1,1) = {"
tw
tw
KM
tv
Tv
CR
zg
hP
KM
"}
(4,1,1) = {"
tw
tw
KM
sD
Dq
vW
KM
KM
KM
"}
(5,1,1) = {"
tw
tw
KM
Vf
Dq
cY
KM
tw
tw
"}
(6,1,1) = {"
tw
tw
KM
pW
jT
pW
KM
cd
KM
"}
(7,1,1) = {"
KM
KM
KM
ua
Zl
pW
QQ
cx
KM
"}
(8,1,1) = {"
yr
kl
jN
Kp
tb
Ng
MB
nx
KM
"}
(9,1,1) = {"
FS
rB
MR
Ne
tb
zN
FO
Lb
cd
"}
(10,1,1) = {"
Zc
pT
Vr
Co
kQ
pW
tV
ef
KM
"}
(11,1,1) = {"
KM
pW
NH
KH
NH
pW
KM
KM
KM
"}
(12,1,1) = {"
KM
Ty
Xp
vu
OF
tE
KM
tw
tw
"}
(13,1,1) = {"
KM
FY
oV
oV
nk
mg
KM
tw
tw
"}
(14,1,1) = {"
KM
cB
jm
Px
VI
LK
KM
tw
tw
"}
(15,1,1) = {"
KM
pW
NN
KM
wn
KM
KM
tw
tw
"}
(16,1,1) = {"
KM
gr
uQ
ss
DE
RW
KM
tw
tw
"}
(17,1,1) = {"
Fj
TY
tI
nm
DE
tO
KM
tw
tw
"}
(18,1,1) = {"
sC
vo
BM
Uv
hb
ya
KM
xk
tw
"}
(19,1,1) = {"
Fj
JM
ap
wj
DE
sl
KM
tw
tw
"}
(20,1,1) = {"
KM
Mk
VJ
tj
iB
uT
KM
tw
tw
"}
(21,1,1) = {"
Bu
KM
gc
Ke
RY
KM
KM
tw
tw
"}
